"lsoa11cd","CAUTH18NM","date","lsoa11nm","Rural Urban","Variable: All usual residents; measures: Value","Variable: Males; measures: Value","Variable: Females; measures: Value","Variable: Lives in a household; measures: Value","Variable: Lives in a communal establishment; measures: Value","Variable: Schoolchild or full-time student aged 4 and over at their non term-time address; measures: Value","Variable: Area (Hectares); measures: Value","Variable: Density (number of persons per hectare); measures: Value"
"E01007317","Sheffield City Region",2011,"Barnsley 018A","Total",1493,747,746,1493,0,5,62.36,23.9
"E01007318","Sheffield City Region",2011,"Barnsley 018B","Total",1544,781,763,1507,37,9,29.72,52
"E01007319","Sheffield City Region",2011,"Barnsley 015A","Total",1465,718,747,1465,0,8,124.53,11.8
"E01007320","Sheffield City Region",2011,"Barnsley 018C","Total",1596,798,798,1596,0,7,36.92,43.2
"E01007321","Sheffield City Region",2011,"Barnsley 015B","Total",1433,690,743,1433,0,10,176.11,8.1
"E01007322","Sheffield City Region",2011,"Barnsley 015C","Total",2082,1039,1043,2004,78,11,154.12,13.5
"E01007323","Sheffield City Region",2011,"Barnsley 007A","Total",1483,748,735,1483,0,4,29.22,50.8
"E01007324","Sheffield City Region",2011,"Barnsley 007B","Total",1667,819,848,1667,0,5,40.34,41.3
"E01007325","Sheffield City Region",2011,"Barnsley 007C","Total",1714,829,885,1689,25,7,42.72,40.1
"E01007326","Sheffield City Region",2011,"Barnsley 007D","Total",1526,736,790,1525,1,3,37.71,40.5
"E01007327","Sheffield City Region",2011,"Barnsley 007E","Total",1676,809,867,1676,0,13,91.31,18.4
"E01007328","Sheffield City Region",2011,"Barnsley 006A","Total",1922,940,982,1899,23,6,464.45,4.1
"E01007329","Sheffield City Region",2011,"Barnsley 003A","Total",1594,788,806,1565,29,13,195.75,8.1
"E01007330","Sheffield City Region",2011,"Barnsley 006B","Total",1708,826,882,1708,0,13,229.15,7.5
"E01007331","Sheffield City Region",2011,"Barnsley 003B","Total",1853,926,927,1853,0,11,193.34,9.6
"E01007332","Sheffield City Region",2011,"Barnsley 006C","Total",2306,1132,1174,2203,103,14,275.55,8.4
"E01007333","Sheffield City Region",2011,"Barnsley 006D","Total",1331,659,672,1331,0,7,74.17,17.9
"E01007334","Sheffield City Region",2011,"Barnsley 009A","Total",1356,683,673,1356,0,11,53.97,25.1
"E01007335","Sheffield City Region",2011,"Barnsley 009B","Total",1506,739,767,1454,52,10,60.26,25
"E01007336","Sheffield City Region",2011,"Barnsley 013A","Total",1557,801,756,1543,14,7,59.52,26.2
"E01007337","Sheffield City Region",2011,"Barnsley 015D","Total",1775,928,847,1775,0,7,80.3,22.1
"E01007338","Sheffield City Region",2011,"Barnsley 017A","Total",1533,756,777,1533,0,1,27.15,56.5
"E01007339","Sheffield City Region",2011,"Barnsley 017B","Total",1490,763,727,1479,11,9,25.43,58.6
"E01007340","Sheffield City Region",2011,"Barnsley 013B","Total",1636,826,810,1636,0,9,47.49,34.4
"E01007341","Sheffield City Region",2011,"Barnsley 008A","Total",1264,627,637,1264,0,8,94.92,13.3
"E01007342","Sheffield City Region",2011,"Barnsley 003C","Total",1398,686,712,1398,0,13,140.98,9.9
"E01007343","Sheffield City Region",2011,"Barnsley 003D","Total",1346,656,690,1346,0,8,101.48,13.3
"E01007344","Sheffield City Region",2011,"Barnsley 011A","Total",2135,1069,1066,2128,7,15,127.74,16.7
"E01007345","Sheffield City Region",2011,"Barnsley 008B","Total",1620,800,820,1567,53,11,47.93,33.8
"E01007346","Sheffield City Region",2011,"Barnsley 008C","Total",1620,788,832,1620,0,12,64.12,25.3
"E01007347","Sheffield City Region",2011,"Barnsley 008D","Total",1594,791,803,1594,0,10,254.85,6.3
"E01007348","Sheffield City Region",2011,"Barnsley 020A","Total",1444,696,748,1399,45,9,75.65,19.1
"E01007349","Sheffield City Region",2011,"Barnsley 020B","Total",1533,728,805,1529,4,9,518.08,3
"E01007350","Sheffield City Region",2011,"Barnsley 020C","Total",1185,600,585,1183,2,7,494.11,2.4
"E01007351","Sheffield City Region",2011,"Barnsley 020D","Total",1426,699,727,1426,0,23,361.32,3.9
"E01007352","Sheffield City Region",2011,"Barnsley 020E","Total",1412,683,729,1412,0,8,26.78,52.7
"E01007353","Sheffield City Region",2011,"Barnsley 020F","Total",1605,771,834,1583,22,14,52.52,30.6
"E01007354","Sheffield City Region",2011,"Barnsley 020G","Total",1681,817,864,1645,36,8,543.13,3.1
"E01007355","Sheffield City Region",2011,"Barnsley 005A","Total",1537,773,764,1537,0,8,64.33,23.9
"E01007356","Sheffield City Region",2011,"Barnsley 004A","Total",1381,669,712,1381,0,17,154.37,8.9
"E01007357","Sheffield City Region",2011,"Barnsley 004B","Total",1397,667,730,1347,50,6,27.38,51
"E01007358","Sheffield City Region",2011,"Barnsley 005B","Total",1497,717,780,1497,0,19,115.51,13
"E01007359","Sheffield City Region",2011,"Barnsley 005C","Total",1509,739,770,1509,0,15,516.22,2.9
"E01007360","Sheffield City Region",2011,"Barnsley 005D","Total",1546,733,813,1522,24,19,138.62,11.2
"E01007361","Sheffield City Region",2011,"Barnsley 004C","Total",1656,799,857,1585,71,12,126.03,13.1
"E01007362","Sheffield City Region",2011,"Barnsley 004D","Total",1633,816,817,1633,0,13,150.61,10.8
"E01007363","Sheffield City Region",2011,"Barnsley 004E","Total",1575,755,820,1575,0,11,72.29,21.8
"E01007364","Sheffield City Region",2011,"Barnsley 025A","Total",1390,662,728,1390,0,5,104.93,13.2
"E01007365","Sheffield City Region",2011,"Barnsley 025B","Total",1212,564,648,1203,9,2,56,21.6
"E01007366","Sheffield City Region",2011,"Barnsley 025C","Total",2005,991,1014,2005,0,9,133.91,15
"E01007367","Sheffield City Region",2011,"Barnsley 025D","Total",1178,590,588,1178,0,5,161.99,7.3
"E01007368","Sheffield City Region",2011,"Barnsley 025E","Total",1675,814,861,1626,49,7,39.51,42.4
"E01007369","Sheffield City Region",2011,"Barnsley 022A","Total",1490,762,728,1490,0,9,51.97,28.7
"E01007370","Sheffield City Region",2011,"Barnsley 022B","Total",1389,683,706,1389,0,10,249.75,5.6
"E01007371","Sheffield City Region",2011,"Barnsley 022C","Total",1954,957,997,1954,0,18,102.1,19.1
"E01007372","Sheffield City Region",2011,"Barnsley 014A","Total",1287,608,679,1281,6,5,58.34,22.1
"E01007373","Sheffield City Region",2011,"Barnsley 014B","Total",1594,809,785,1594,0,8,69.08,23.1
"E01007374","Sheffield City Region",2011,"Barnsley 014C","Total",1470,704,766,1470,0,4,184.44,8
"E01007375","Sheffield City Region",2011,"Barnsley 014D","Total",1659,792,867,1605,54,5,68.39,24.3
"E01007376","Sheffield City Region",2011,"Barnsley 022D","Total",1407,691,716,1403,4,3,154.86,9.1
"E01007377","Sheffield City Region",2011,"Barnsley 014E","Total",1105,561,544,1105,0,6,34.08,32.4
"E01007378","Sheffield City Region",2011,"Barnsley 014F","Total",1572,771,801,1556,16,5,89.14,17.6
"E01007379","Sheffield City Region",2011,"Barnsley 012A","Total",1591,764,827,1591,0,10,321.19,5
"E01007380","Sheffield City Region",2011,"Barnsley 012B","Total",1810,910,900,1810,0,26,117.25,15.4
"E01007381","Sheffield City Region",2011,"Barnsley 012C","Total",1547,759,788,1547,0,24,152.85,10.1
"E01007382","Sheffield City Region",2011,"Barnsley 019A","Total",1483,714,769,1483,0,11,143.04,10.4
"E01007383","Sheffield City Region",2011,"Barnsley 019B","Total",1370,698,672,1370,0,22,48.16,28.4
"E01007384","Sheffield City Region",2011,"Barnsley 019C","Total",1614,798,816,1614,0,15,312.18,5.2
"E01007385","Sheffield City Region",2011,"Barnsley 019D","Total",1433,688,745,1369,64,8,72.11,19.9
"E01007386","Sheffield City Region",2011,"Barnsley 005E","Total",1714,830,884,1701,13,22,144.82,11.8
"E01007387","Sheffield City Region",2011,"Barnsley 012D","Total",1452,716,736,1452,0,8,77.71,18.7
"E01007388","Sheffield City Region",2011,"Barnsley 029A","Total",1615,815,800,1615,0,15,172.03,9.4
"E01007389","Sheffield City Region",2011,"Barnsley 030A","Total",1396,701,695,1396,0,7,57.28,24.4
"E01007390","Sheffield City Region",2011,"Barnsley 030B","Total",1527,744,783,1527,0,8,107.13,14.3
"E01007391","Sheffield City Region",2011,"Barnsley 030C","Total",1468,723,745,1468,0,6,33.75,43.5
"E01007392","Sheffield City Region",2011,"Barnsley 030D","Total",1538,763,775,1498,40,9,33.57,45.8
"E01007393","Sheffield City Region",2011,"Barnsley 029B","Total",1837,882,955,1811,26,9,32.21,57
"E01007394","Sheffield City Region",2011,"Barnsley 029C","Total",1384,687,697,1384,0,4,23.93,57.8
"E01007395","Sheffield City Region",2011,"Barnsley 030E","Total",2016,956,1060,2016,0,15,142.83,14.1
"E01007396","Sheffield City Region",2011,"Barnsley 028A","Total",1580,754,826,1580,0,11,29.72,53.2
"E01007397","Sheffield City Region",2011,"Barnsley 028B","Total",1456,681,775,1422,34,10,132.22,11
"E01007398","Sheffield City Region",2011,"Barnsley 028C","Total",1632,784,848,1619,13,9,344.38,4.7
"E01007399","Sheffield City Region",2011,"Barnsley 028D","Total",2057,993,1064,2057,0,13,232.74,8.8
"E01007400","Sheffield City Region",2011,"Barnsley 009C","Total",2017,1018,999,2017,0,13,84.6,23.8
"E01007402","Sheffield City Region",2011,"Barnsley 011B","Total",1660,782,878,1660,0,7,199.9,8.3
"E01007403","Sheffield City Region",2011,"Barnsley 011C","Total",1536,754,782,1495,41,4,71.2,21.6
"E01007404","Sheffield City Region",2011,"Barnsley 009D","Total",1287,642,645,1287,0,9,45.48,28.3
"E01007405","Sheffield City Region",2011,"Barnsley 011D","Total",1418,653,765,1334,84,9,62.74,22.6
"E01007406","Sheffield City Region",2011,"Barnsley 009E","Total",1720,840,880,1720,0,2,125.72,13.7
"E01007408","Sheffield City Region",2011,"Barnsley 010C","Total",1516,719,797,1485,31,13,27.05,56
"E01007409","Sheffield City Region",2011,"Barnsley 010D","Total",1458,734,724,1428,30,21,35.74,40.8
"E01007410","Sheffield City Region",2011,"Barnsley 010E","Total",1631,792,839,1631,0,12,47.93,34
"E01007411","Sheffield City Region",2011,"Barnsley 007F","Total",1191,605,586,1191,0,3,51.91,22.9
"E01007413","Sheffield City Region",2011,"Barnsley 017C","Total",1349,650,699,1349,0,5,43.35,31.1
"E01007414","Sheffield City Region",2011,"Barnsley 017D","Total",1638,788,850,1572,66,22,42.38,38.7
"E01007415","Sheffield City Region",2011,"Barnsley 013C","Total",1495,732,763,1478,17,11,117.22,12.8
"E01007416","Sheffield City Region",2011,"Barnsley 018D","Total",1194,577,617,1194,0,9,36.54,32.7
"E01007417","Sheffield City Region",2011,"Barnsley 013D","Total",1591,789,802,1552,39,10,20.67,77
"E01007418","Sheffield City Region",2011,"Barnsley 016A","Total",1279,618,661,1279,0,19,1843.89,0.7
"E01007419","Sheffield City Region",2011,"Barnsley 016B","Total",1721,828,893,1721,0,24,325.02,5.3
"E01007420","Sheffield City Region",2011,"Barnsley 016C","Total",1432,703,729,1432,0,29,305.67,4.7
"E01007421","Sheffield City Region",2011,"Barnsley 027A","Total",1330,669,661,1320,10,20,2814.72,0.5
"E01007422","Sheffield City Region",2011,"Barnsley 027B","Total",1571,808,763,1571,0,31,1201.33,1.3
"E01007423","Sheffield City Region",2011,"Barnsley 027C","Total",1655,809,846,1655,0,25,851.83,1.9
"E01007424","Sheffield City Region",2011,"Barnsley 028E","Total",1671,817,854,1671,0,13,828.08,2
"E01007425","Sheffield City Region",2011,"Barnsley 016D","Total",1470,737,733,1470,0,31,1086.56,1.4
"E01007426","Sheffield City Region",2011,"Barnsley 027D","Total",1558,785,773,1547,11,17,6511.97,0.2
"E01007427","Sheffield City Region",2011,"Barnsley 024A","Total",1554,787,767,1554,0,22,84.49,18.4
"E01007428","Sheffield City Region",2011,"Barnsley 024B","Total",1445,715,730,1444,1,18,624.1,2.3
"E01007429","Sheffield City Region",2011,"Barnsley 024C","Total",1422,674,748,1422,0,7,32.03,44.4
"E01007430","Sheffield City Region",2011,"Barnsley 024D","Total",2277,1130,1147,2273,4,28,80.47,28.3
"E01007431","Sheffield City Region",2011,"Barnsley 024E","Total",1363,677,686,1363,0,21,125.26,10.9
"E01007432","Sheffield City Region",2011,"Barnsley 024F","Total",1431,709,722,1431,0,25,59.75,23.9
"E01007433","Sheffield City Region",2011,"Barnsley 002A","Total",1615,775,840,1615,0,7,238.31,6.8
"E01007434","Sheffield City Region",2011,"Barnsley 001A","Total",1933,963,970,1924,9,11,60.93,31.7
"E01007435","Sheffield City Region",2011,"Barnsley 001B","Total",1579,771,808,1579,0,16,42.08,37.5
"E01007436","Sheffield City Region",2011,"Barnsley 002B","Total",1267,620,647,1267,0,9,84.3,15
"E01007437","Sheffield City Region",2011,"Barnsley 002C","Total",1476,755,721,1476,0,11,109.3,13.5
"E01007438","Sheffield City Region",2011,"Barnsley 001C","Total",1557,722,835,1497,60,18,93.17,16.7
"E01007439","Sheffield City Region",2011,"Barnsley 001D","Total",1210,607,603,1210,0,14,250.55,4.8
"E01007440","Sheffield City Region",2011,"Barnsley 002D","Total",1520,753,767,1520,0,13,40.68,37.4
"E01007441","Sheffield City Region",2011,"Barnsley 013E","Total",1537,773,764,1537,0,11,23.22,66.2
"E01007442","Sheffield City Region",2011,"Barnsley 012E","Total",1377,670,707,1377,0,14,127.41,10.8
"E01007443","Sheffield City Region",2011,"Barnsley 013F","Total",2000,1086,914,2000,0,21,22.99,87
"E01007444","Sheffield City Region",2011,"Barnsley 012F","Total",1550,759,791,1516,34,15,66.52,23.3
"E01007445","Sheffield City Region",2011,"Barnsley 013G","Total",1451,715,736,1451,0,6,50.91,28.5
"E01007446","Sheffield City Region",2011,"Barnsley 012G","Total",1335,650,685,1308,27,10,41.22,32.4
"E01007447","Sheffield City Region",2011,"Barnsley 023A","Total",1544,750,794,1538,6,5,33.31,46.4
"E01007448","Sheffield City Region",2011,"Barnsley 023B","Total",1594,828,766,1593,1,6,98.93,16.1
"E01007449","Sheffield City Region",2011,"Barnsley 023C","Total",1770,887,883,1770,0,3,141.77,12.5
"E01007450","Sheffield City Region",2011,"Barnsley 023D","Total",1516,763,753,1497,19,6,117.62,12.9
"E01007451","Sheffield City Region",2011,"Barnsley 026A","Total",1712,845,867,1683,29,11,102.26,16.7
"E01007452","Sheffield City Region",2011,"Barnsley 026B","Total",1555,777,778,1555,0,13,92.94,16.7
"E01007453","Sheffield City Region",2011,"Barnsley 026C","Total",1558,721,837,1558,0,9,29.06,53.6
"E01007455","Sheffield City Region",2011,"Barnsley 026E","Total",1358,666,692,1358,0,11,61.04,22.2
"E01007456","Sheffield City Region",2011,"Barnsley 029D","Total",1756,854,902,1756,0,10,130.2,13.5
"E01007457","Sheffield City Region",2011,"Barnsley 029E","Total",1648,793,855,1648,0,10,381.91,4.3
"E01007458","Sheffield City Region",2011,"Barnsley 021A","Total",1455,727,728,1432,23,13,207.69,7
"E01007459","Sheffield City Region",2011,"Barnsley 021B","Total",1509,726,783,1509,0,3,364.68,4.1
"E01007460","Sheffield City Region",2011,"Barnsley 021C","Total",1437,720,717,1427,10,16,61.08,23.5
"E01007461","Sheffield City Region",2011,"Barnsley 021D","Total",1647,844,803,1641,6,9,44.42,37.1
"E01007462","Sheffield City Region",2011,"Barnsley 021E","Total",1602,741,861,1602,0,9,153.83,10.4
"E01007463","Sheffield City Region",2011,"Barnsley 021F","Total",1766,843,923,1747,19,4,33.29,53
"E01007464","Sheffield City Region",2011,"Doncaster 009A","Total",1497,728,769,1497,0,9,58.63,25.5
"E01007465","Sheffield City Region",2011,"Doncaster 009B","Total",1483,721,762,1483,0,9,65.23,22.7
"E01007466","Sheffield City Region",2011,"Doncaster 009C","Total",1755,855,900,1755,0,8,90.62,19.4
"E01007467","Sheffield City Region",2011,"Doncaster 009D","Total",1553,767,786,1523,30,4,62.82,24.7
"E01007468","Sheffield City Region",2011,"Doncaster 005A","Total",1296,612,684,1296,0,5,102.62,12.6
"E01007469","Sheffield City Region",2011,"Doncaster 005B","Total",1355,675,680,1326,29,6,68.12,19.9
"E01007470","Sheffield City Region",2011,"Doncaster 005C","Total",1428,708,720,1428,0,7,27.79,51.4
"E01007471","Sheffield City Region",2011,"Doncaster 009E","Total",1542,762,780,1507,35,14,73.21,21.1
"E01007472","Sheffield City Region",2011,"Doncaster 005D","Total",1624,799,825,1593,31,12,25.11,64.7
"E01007473","Sheffield City Region",2011,"Doncaster 005E","Total",1457,721,736,1430,27,5,258.75,5.6
"E01007474","Sheffield City Region",2011,"Doncaster 005F","Total",1325,611,714,1321,4,5,155.16,8.5
"E01007475","Sheffield City Region",2011,"Doncaster 011A","Total",1549,768,781,1549,0,27,190.45,8.1
"E01007476","Sheffield City Region",2011,"Doncaster 011B","Total",1457,685,772,1439,18,9,40.39,36.1
"E01007477","Sheffield City Region",2011,"Doncaster 011C","Total",1431,690,741,1431,0,11,46.21,31
"E01007478","Sheffield City Region",2011,"Doncaster 011D","Total",1532,780,752,1532,0,20,139.39,11
"E01007479","Sheffield City Region",2011,"Doncaster 014A","Total",1593,785,808,1593,0,11,493.54,3.2
"E01007480","Sheffield City Region",2011,"Doncaster 014B","Total",1509,723,786,1472,37,6,32.32,46.7
"E01007482","Sheffield City Region",2011,"Doncaster 014D","Total",1374,632,742,1350,24,3,29.52,46.5
"E01007483","Sheffield City Region",2011,"Doncaster 017A","Total",1381,663,718,1381,0,18,218.28,6.3
"E01007484","Sheffield City Region",2011,"Doncaster 017B","Total",1445,704,741,1382,63,15,32.77,44.1
"E01007485","Sheffield City Region",2011,"Doncaster 017C","Total",1435,697,738,1435,0,14,157.72,9.1
"E01007486","Sheffield City Region",2011,"Doncaster 017D","Total",1317,640,677,1317,0,6,28.55,46.1
"E01007487","Sheffield City Region",2011,"Doncaster 002A","Total",1615,771,844,1615,0,13,173,9.3
"E01007488","Sheffield City Region",2011,"Doncaster 002B","Total",1738,897,841,1735,3,15,4207.7,0.4
"E01007489","Sheffield City Region",2011,"Doncaster 002C","Total",1721,847,874,1673,48,10,481.61,3.6
"E01007490","Sheffield City Region",2011,"Doncaster 002D","Total",1565,782,783,1550,15,17,1558.69,1
"E01007491","Sheffield City Region",2011,"Doncaster 002E","Total",1754,854,900,1754,0,5,24.26,72.3
"E01007492","Sheffield City Region",2011,"Doncaster 002F","Total",1496,726,770,1496,0,5,139.15,10.8
"E01007493","Sheffield City Region",2011,"Doncaster 002G","Total",1784,879,905,1736,48,14,255.21,7
"E01007494","Sheffield City Region",2011,"Doncaster 023A","Total",1529,764,765,1529,0,20,46.65,32.8
"E01007495","Sheffield City Region",2011,"Doncaster 028A","Total",1857,888,969,1857,0,20,156.2,11.9
"E01007496","Sheffield City Region",2011,"Doncaster 029A","Total",1622,797,825,1622,0,11,30.63,53
"E01007497","Sheffield City Region",2011,"Doncaster 029B","Total",1376,661,715,1376,0,12,21.95,62.7
"E01007498","Sheffield City Region",2011,"Doncaster 029C","Total",1580,803,777,1576,4,15,46.49,34
"E01007499","Sheffield City Region",2011,"Doncaster 029D","Total",1501,694,807,1452,49,15,29.91,50.2
"E01007500","Sheffield City Region",2011,"Doncaster 028B","Total",1308,638,670,1308,0,11,46.7,28
"E01007501","Sheffield City Region",2011,"Doncaster 029E","Total",1456,707,749,1456,0,16,37.18,39.2
"E01007502","Sheffield City Region",2011,"Doncaster 028C","Total",2750,1387,1363,2710,40,34,175.17,15.7
"E01007503","Sheffield City Region",2011,"Doncaster 029F","Total",1620,819,801,1617,3,13,50.48,32.1
"E01007504","Sheffield City Region",2011,"Doncaster 009F","Total",1532,765,767,1532,0,5,330.31,4.6
"E01007505","Sheffield City Region",2011,"Doncaster 013A","Total",1673,844,829,1654,19,16,409.94,4.1
"E01007506","Sheffield City Region",2011,"Doncaster 010A","Total",1441,708,733,1397,44,3,136.38,10.6
"E01007507","Sheffield City Region",2011,"Doncaster 009G","Total",1375,693,682,1375,0,9,138.13,10
"E01007508","Sheffield City Region",2011,"Doncaster 010B","Total",1664,808,856,1664,0,15,67.86,24.5
"E01007509","Sheffield City Region",2011,"Doncaster 010C","Total",1760,847,913,1758,2,9,47.59,37
"E01007510","Sheffield City Region",2011,"Doncaster 010D","Total",1568,720,848,1539,29,12,38.14,41.1
"E01007511","Sheffield City Region",2011,"Doncaster 010E","Total",1576,751,825,1576,0,6,919.6,1.7
"E01007512","Sheffield City Region",2011,"Doncaster 012A","Total",1671,827,844,1668,3,8,46.73,35.8
"E01007513","Sheffield City Region",2011,"Doncaster 012B","Total",1435,657,778,1435,0,11,51.61,27.8
"E01007514","Sheffield City Region",2011,"Doncaster 013B","Total",1465,734,731,1465,0,6,21.69,67.5
"E01007515","Sheffield City Region",2011,"Doncaster 012C","Total",1570,773,797,1554,16,18,33.35,47.1
"E01007516","Sheffield City Region",2011,"Doncaster 013C","Total",1336,652,684,1336,0,19,39.04,34.2
"E01007517","Sheffield City Region",2011,"Doncaster 013D","Total",1553,756,797,1551,2,14,51.86,29.9
"E01007518","Sheffield City Region",2011,"Doncaster 012D","Total",1489,715,774,1486,3,21,111.5,13.4
"E01007519","Sheffield City Region",2011,"Doncaster 012E","Total",1298,622,676,1298,0,9,26.24,49.5
"E01007520","Sheffield City Region",2011,"Doncaster 027A","Total",1418,675,743,1411,7,24,64.06,22.1
"E01007521","Sheffield City Region",2011,"Doncaster 025A","Total",1491,698,793,1435,56,33,40.35,37
"E01007522","Sheffield City Region",2011,"Doncaster 024A","Total",1550,758,792,1511,39,9,36.61,42.3
"E01007523","Sheffield City Region",2011,"Doncaster 025B","Total",1486,717,769,1486,0,17,33.79,44
"E01007524","Sheffield City Region",2011,"Doncaster 025C","Total",1581,790,791,1581,0,33,50.47,31.3
"E01007525","Sheffield City Region",2011,"Doncaster 024B","Total",1532,706,826,1532,0,11,185.63,8.3
"E01007526","Sheffield City Region",2011,"Doncaster 025D","Total",1633,773,860,1606,27,39,96.06,17
"E01007527","Sheffield City Region",2011,"Doncaster 027B","Total",2325,1156,1169,2325,0,42,114.52,20.3
"E01007528","Sheffield City Region",2011,"Doncaster 024C","Total",1392,659,733,1389,3,8,50.87,27.4
"E01007529","Sheffield City Region",2011,"Doncaster 022A","Total",2047,1329,718,1448,599,10,78.67,26
"E01007530","Sheffield City Region",2011,"Doncaster 022B","Total",1206,616,590,1206,0,3,66.85,18
"E01007531","Sheffield City Region",2011,"Doncaster 022C","Total",1625,820,805,1618,7,12,69.12,23.5
"E01007532","Sheffield City Region",2011,"Doncaster 023B","Total",1774,1030,744,1771,3,9,26.59,66.7
"E01007533","Sheffield City Region",2011,"Doncaster 023C","Total",1419,735,684,1419,0,11,40.98,34.6
"E01007534","Sheffield City Region",2011,"Doncaster 028D","Total",2022,1061,961,2018,4,11,221.31,9.1
"E01007535","Sheffield City Region",2011,"Doncaster 023D","Total",1596,784,812,1544,52,6,16.84,94.8
"E01007536","Sheffield City Region",2011,"Doncaster 032A","Total",1971,982,989,1952,19,10,87.02,22.6
"E01007537","Sheffield City Region",2011,"Doncaster 035A","Total",1733,842,891,1733,0,10,53.52,32.4
"E01007538","Sheffield City Region",2011,"Doncaster 035B","Total",1530,722,808,1530,0,8,46.47,32.9
"E01007539","Sheffield City Region",2011,"Doncaster 035C","Total",1443,682,761,1398,45,8,32.88,43.9
"E01007540","Sheffield City Region",2011,"Doncaster 035D","Total",1633,796,837,1633,0,10,40.28,40.5
"E01007541","Sheffield City Region",2011,"Doncaster 035E","Total",1520,773,747,1517,3,3,84.42,18
"E01007542","Sheffield City Region",2011,"Doncaster 032B","Total",1778,864,914,1772,6,5,107.61,16.5
"E01007543","Sheffield City Region",2011,"Doncaster 032C","Total",1500,710,790,1500,0,10,339.66,4.4
"E01007544","Sheffield City Region",2011,"Doncaster 032D","Total",1752,836,916,1674,78,5,36.38,48.2
"E01007545","Sheffield City Region",2011,"Doncaster 034A","Total",1484,736,748,1456,28,6,420.61,3.5
"E01007546","Sheffield City Region",2011,"Doncaster 033A","Total",1428,709,719,1425,3,10,68.67,20.8
"E01007547","Sheffield City Region",2011,"Doncaster 034B","Total",1529,753,776,1529,0,3,41.73,36.6
"E01007548","Sheffield City Region",2011,"Doncaster 034C","Total",1103,506,597,1103,0,5,31.76,34.7
"E01007549","Sheffield City Region",2011,"Doncaster 034D","Total",1455,711,744,1439,16,8,51.94,28
"E01007550","Sheffield City Region",2011,"Doncaster 034E","Total",1665,793,872,1665,0,10,204.51,8.1
"E01007551","Sheffield City Region",2011,"Doncaster 033B","Total",1671,840,831,1671,0,18,152.7,10.9
"E01007552","Sheffield City Region",2011,"Doncaster 033C","Total",1408,674,734,1408,0,17,99.32,14.2
"E01007553","Sheffield City Region",2011,"Doncaster 008A","Total",1693,845,848,1648,45,19,227.28,7.4
"E01007554","Sheffield City Region",2011,"Doncaster 006A","Total",1594,787,807,1594,0,23,150.66,10.6
"E01007555","Sheffield City Region",2011,"Doncaster 006B","Total",1464,667,797,1464,0,8,46.99,31.2
"E01007556","Sheffield City Region",2011,"Doncaster 006C","Total",1364,661,703,1364,0,6,65.24,20.9
"E01007557","Sheffield City Region",2011,"Doncaster 008B","Total",2784,2284,500,1002,1782,12,2190.79,1.3
"E01007558","Sheffield City Region",2011,"Doncaster 008C","Total",1453,715,738,1453,0,21,25.86,56.2
"E01007559","Sheffield City Region",2011,"Doncaster 008D","Total",1162,686,476,941,221,19,2921.02,0.4
"E01007560","Sheffield City Region",2011,"Doncaster 008E","Total",1523,728,795,1497,26,14,170.1,9
"E01007561","Sheffield City Region",2011,"Doncaster 006D","Total",1472,716,756,1393,79,15,264.67,5.6
"E01007562","Sheffield City Region",2011,"Doncaster 006E","Total",1362,682,680,1362,0,9,86.33,15.8
"E01007563","Sheffield City Region",2011,"Doncaster 006F","Total",1455,695,760,1451,4,1,56.95,25.5
"E01007564","Sheffield City Region",2011,"Doncaster 018A","Total",1536,716,820,1536,0,11,29.27,52.5
"E01007565","Sheffield City Region",2011,"Doncaster 018B","Total",1527,740,787,1512,15,24,35.1,43.5
"E01007566","Sheffield City Region",2011,"Doncaster 018C","Total",1626,800,826,1626,0,4,117.94,13.8
"E01007567","Sheffield City Region",2011,"Doncaster 018D","Total",1342,656,686,1302,40,17,33.45,40.1
"E01007568","Sheffield City Region",2011,"Doncaster 018E","Total",1662,777,885,1662,0,13,24.62,67.5
"E01007569","Sheffield City Region",2011,"Doncaster 018F","Total",1601,752,849,1601,0,10,35.86,44.6
"E01007570","Sheffield City Region",2011,"Doncaster 015A","Total",1482,691,791,1482,0,14,31.92,46.4
"E01007571","Sheffield City Region",2011,"Doncaster 031A","Total",1610,797,813,1607,3,7,32.46,49.6
"E01007572","Sheffield City Region",2011,"Doncaster 031B","Total",1416,705,711,1416,0,14,38.34,36.9
"E01007573","Sheffield City Region",2011,"Doncaster 031C","Total",1546,763,783,1546,0,7,30.74,50.3
"E01007574","Sheffield City Region",2011,"Doncaster 031D","Total",1577,738,839,1482,95,6,39.93,39.5
"E01007575","Sheffield City Region",2011,"Doncaster 030A","Total",1408,632,776,1408,0,7,26.99,52.2
"E01007576","Sheffield City Region",2011,"Doncaster 031E","Total",1518,733,785,1518,0,10,25.29,60
"E01007577","Sheffield City Region",2011,"Doncaster 031F","Total",1540,767,773,1486,54,5,30.68,50.2
"E01007578","Sheffield City Region",2011,"Doncaster 030B","Total",1616,807,809,1616,0,5,51.6,31.3
"E01007579","Sheffield City Region",2011,"Doncaster 030C","Total",1504,775,729,1504,0,10,237.68,6.3
"E01007580","Sheffield City Region",2011,"Doncaster 030D","Total",1378,707,671,1378,0,9,72.15,19.1
"E01007581","Sheffield City Region",2011,"Doncaster 016A","Total",1559,784,775,1559,0,28,177.61,8.8
"E01007582","Sheffield City Region",2011,"Doncaster 016B","Total",1457,709,748,1457,0,21,28.41,51.3
"E01007583","Sheffield City Region",2011,"Doncaster 020A","Total",1455,701,754,1452,3,14,2084.8,0.7
"E01007584","Sheffield City Region",2011,"Doncaster 021A","Total",1548,738,810,1548,0,13,83.15,18.6
"E01007585","Sheffield City Region",2011,"Doncaster 021B","Total",1606,738,868,1585,21,20,104.39,15.4
"E01007586","Sheffield City Region",2011,"Doncaster 020B","Total",1522,743,779,1487,35,22,601.92,2.5
"E01007587","Sheffield City Region",2011,"Doncaster 020C","Total",1542,718,824,1542,0,24,4112.18,0.4
"E01007588","Sheffield City Region",2011,"Doncaster 016C","Total",1692,814,878,1673,19,11,127.28,13.3
"E01007589","Sheffield City Region",2011,"Doncaster 016D","Total",1712,832,880,1712,0,30,35.58,48.1
"E01007590","Sheffield City Region",2011,"Doncaster 037A","Total",1215,605,610,1212,3,6,36.03,33.7
"E01007591","Sheffield City Region",2011,"Doncaster 036A","Total",1452,713,739,1452,0,8,22.14,65.6
"E01007592","Sheffield City Region",2011,"Doncaster 037B","Total",1652,786,866,1589,63,10,31.3,52.8
"E01007593","Sheffield City Region",2011,"Doncaster 037C","Total",1306,618,688,1306,0,2,264.93,4.9
"E01007594","Sheffield City Region",2011,"Doncaster 036B","Total",2036,1011,1025,2019,17,17,493.37,4.1
"E01007595","Sheffield City Region",2011,"Doncaster 037D","Total",1528,726,802,1471,57,3,33.97,45
"E01007596","Sheffield City Region",2011,"Doncaster 036C","Total",1246,598,648,1205,41,18,161.12,7.7
"E01007597","Sheffield City Region",2011,"Doncaster 037E","Total",1568,714,854,1568,0,5,117.28,13.4
"E01007598","Sheffield City Region",2011,"Doncaster 036D","Total",1534,772,762,1532,2,14,70.2,21.9
"E01007599","Sheffield City Region",2011,"Doncaster 026A","Total",1763,861,902,1763,0,25,1560.31,1.1
"E01007600","Sheffield City Region",2011,"Doncaster 026B","Total",1434,694,740,1434,0,37,266.48,5.4
"E01007601","Sheffield City Region",2011,"Doncaster 026C","Total",1367,653,714,1367,0,23,144.3,9.5
"E01007602","Sheffield City Region",2011,"Doncaster 026D","Total",1500,735,765,1500,0,27,412.63,3.6
"E01007603","Sheffield City Region",2011,"Doncaster 026E","Total",1484,728,756,1467,17,22,1103.03,1.3
"E01007604","Sheffield City Region",2011,"Doncaster 024D","Total",1431,693,738,1426,5,29,30.69,46.6
"E01007605","Sheffield City Region",2011,"Doncaster 027C","Total",1543,762,781,1509,34,25,52.18,29.6
"E01007606","Sheffield City Region",2011,"Doncaster 027D","Total",1536,792,744,1524,12,43,326.62,4.7
"E01007607","Sheffield City Region",2011,"Doncaster 025E","Total",1444,693,751,1412,32,28,37.73,38.3
"E01007608","Sheffield City Region",2011,"Doncaster 038A","Total",1707,832,875,1701,6,26,407.75,4.2
"E01007609","Sheffield City Region",2011,"Doncaster 038B","Total",2310,1129,1181,2305,5,45,1795.76,1.3
"E01007610","Sheffield City Region",2011,"Doncaster 038C","Total",1799,873,926,1795,4,34,152.49,11.8
"E01007611","Sheffield City Region",2011,"Doncaster 039A","Total",1293,624,669,1293,0,20,1839.17,0.7
"E01007612","Sheffield City Region",2011,"Doncaster 039B","Total",1378,662,716,1378,0,23,1300.99,1.1
"E01007613","Sheffield City Region",2011,"Doncaster 033D","Total",1579,781,798,1548,31,22,2852.08,0.6
"E01007614","Sheffield City Region",2011,"Doncaster 039C","Total",1353,655,698,1257,96,35,1384.92,1
"E01007615","Sheffield City Region",2011,"Doncaster 039D","Total",1258,576,682,1258,0,7,48.33,26
"E01007616","Sheffield City Region",2011,"Doncaster 039E","Total",1239,573,666,1239,0,17,45.71,27.1
"E01007617","Sheffield City Region",2011,"Doncaster 021C","Total",1511,716,795,1511,0,24,465.54,3.2
"E01007618","Sheffield City Region",2011,"Doncaster 021D","Total",1267,613,654,1248,19,38,68.33,18.5
"E01007619","Sheffield City Region",2011,"Doncaster 021E","Total",1810,894,916,1810,0,45,152.51,11.9
"E01007620","Sheffield City Region",2011,"Doncaster 020D","Total",1606,786,820,1606,0,17,509.08,3.2
"E01007621","Sheffield City Region",2011,"Doncaster 007A","Total",1410,691,719,1410,0,15,218.41,6.5
"E01007622","Sheffield City Region",2011,"Doncaster 007B","Total",1515,733,782,1515,0,15,57.69,26.3
"E01007623","Sheffield City Region",2011,"Doncaster 007C","Total",1224,607,617,1224,0,6,29.37,41.7
"E01007624","Sheffield City Region",2011,"Doncaster 007D","Total",1864,929,935,1858,6,22,422.18,4.4
"E01007625","Sheffield City Region",2011,"Doncaster 004A","Total",1537,783,754,1537,0,15,2889.48,0.5
"E01007626","Sheffield City Region",2011,"Doncaster 004B","Total",1226,626,600,1193,33,5,404.35,3
"E01007627","Sheffield City Region",2011,"Doncaster 004C","Total",1671,786,885,1671,0,3,129.18,12.9
"E01007628","Sheffield City Region",2011,"Doncaster 004D","Total",1439,688,751,1404,35,5,23.44,61.4
"E01007629","Sheffield City Region",2011,"Doncaster 004E","Total",1606,779,827,1606,0,4,69.36,23.2
"E01007630","Sheffield City Region",2011,"Doncaster 007E","Total",1358,668,690,1358,0,8,588.41,2.3
"E01007631","Sheffield City Region",2011,"Doncaster 007F","Total",1221,594,627,1221,0,10,24.58,49.7
"E01007632","Sheffield City Region",2011,"Doncaster 001A","Total",1617,782,835,1617,0,9,3556.51,0.5
"E01007633","Sheffield City Region",2011,"Doncaster 001B","Total",1355,660,695,1355,0,11,186.14,7.3
"E01007634","Sheffield City Region",2011,"Doncaster 001C","Total",1636,803,833,1636,0,11,80.18,20.4
"E01007635","Sheffield City Region",2011,"Doncaster 001D","Total",1410,681,729,1410,0,10,229.26,6.2
"E01007636","Sheffield City Region",2011,"Doncaster 003A","Total",1521,718,803,1517,4,7,42.35,35.9
"E01007637","Sheffield City Region",2011,"Doncaster 003B","Total",1542,722,820,1489,53,21,48.54,31.8
"E01007638","Sheffield City Region",2011,"Doncaster 003C","Total",1587,760,827,1587,0,15,39.43,40.2
"E01007639","Sheffield City Region",2011,"Doncaster 003D","Total",1894,951,943,1832,62,19,52.45,36.1
"E01007640","Sheffield City Region",2011,"Doncaster 003E","Total",1616,815,801,1616,0,16,329.19,4.9
"E01007641","Sheffield City Region",2011,"Doncaster 003F","Total",1512,726,786,1479,33,14,78.92,19.2
"E01007642","Sheffield City Region",2011,"Doncaster 003G","Total",1605,780,825,1605,0,7,57.32,28
"E01007643","Sheffield City Region",2011,"Doncaster 022D","Total",1665,799,866,1665,0,9,36.05,46.2
"E01007644","Sheffield City Region",2011,"Doncaster 019A","Total",1549,771,778,1475,74,17,211.26,7.3
"E01007645","Sheffield City Region",2011,"Doncaster 022E","Total",2072,1100,972,1983,89,17,68.76,30.1
"E01007646","Sheffield City Region",2011,"Doncaster 019B","Total",1463,779,684,1341,122,34,25.97,56.3
"E01007647","Sheffield City Region",2011,"Doncaster 019C","Total",1503,712,791,1472,31,16,65.12,23.1
"E01007648","Sheffield City Region",2011,"Doncaster 019D","Total",1884,1047,837,1855,29,10,24.3,77.5
"E01007649","Sheffield City Region",2011,"Doncaster 019E","Total",1549,784,765,1549,0,27,20.76,74.6
"E01007650","Sheffield City Region",2011,"Doncaster 015B","Total",1649,808,841,1649,0,15,97.39,16.9
"E01007651","Sheffield City Region",2011,"Doncaster 015C","Total",1830,868,962,1830,0,24,33.99,53.8
"E01007652","Sheffield City Region",2011,"Doncaster 015D","Total",1889,909,980,1889,0,11,184.63,10.2
"E01007653","Sheffield City Region",2011,"Doncaster 015E","Total",1579,823,756,1579,0,10,39.38,40.1
"E01007654","Sheffield City Region",2011,"Doncaster 019F","Total",1539,783,756,1525,14,9,33.88,45.4
"E01007655","Sheffield City Region",2011,"Doncaster 022F","Total",1893,1017,876,1815,78,20,79.03,24
"E01007656","Sheffield City Region",2011,"Doncaster 015F","Total",1589,742,847,1589,0,4,147.3,10.8
"E01007657","Sheffield City Region",2011,"Rotherham 029A","Total",1447,709,738,1447,0,14,32.11,45.1
"E01007658","Sheffield City Region",2011,"Rotherham 032A","Total",1391,670,721,1391,0,5,277.88,5
"E01007659","Sheffield City Region",2011,"Rotherham 029B","Total",1148,576,572,1148,0,10,31.52,36.4
"E01007660","Sheffield City Region",2011,"Rotherham 032B","Total",1227,628,599,1212,15,15,145.87,8.4
"E01007661","Sheffield City Region",2011,"Rotherham 032C","Total",1401,706,695,1401,0,31,305.42,4.6
"E01007662","Sheffield City Region",2011,"Rotherham 032D","Total",1035,490,545,1035,0,8,20.3,51
"E01007663","Sheffield City Region",2011,"Rotherham 032E","Total",1460,700,760,1460,0,23,68.41,21.3
"E01007664","Sheffield City Region",2011,"Rotherham 032F","Total",1854,893,961,1854,0,36,1031.19,1.8
"E01007665","Sheffield City Region",2011,"Rotherham 027A","Total",1820,906,914,1766,54,10,449.91,4
"E01007666","Sheffield City Region",2011,"Rotherham 026A","Total",1357,672,685,1357,0,11,547.09,2.5
"E01007667","Sheffield City Region",2011,"Rotherham 030A","Total",1359,672,687,1342,17,7,35.22,38.6
"E01007668","Sheffield City Region",2011,"Rotherham 030B","Total",1571,764,807,1571,0,5,26.63,59
"E01007669","Sheffield City Region",2011,"Rotherham 030C","Total",1504,746,758,1497,7,13,84.5,17.8
"E01007670","Sheffield City Region",2011,"Rotherham 030D","Total",1449,713,736,1449,0,22,379.49,3.8
"E01007671","Sheffield City Region",2011,"Rotherham 031A","Total",2117,1042,1075,2117,0,20,93.86,22.6
"E01007672","Sheffield City Region",2011,"Rotherham 030E","Total",1433,702,731,1433,0,15,29.65,48.3
"E01007673","Sheffield City Region",2011,"Rotherham 030F","Total",1496,718,778,1496,0,6,25.58,58.5
"E01007674","Sheffield City Region",2011,"Rotherham 031B","Total",1939,948,991,1939,0,16,190.12,10.2
"E01007675","Sheffield City Region",2011,"Rotherham 023A","Total",1854,895,959,1850,4,32,43.65,42.5
"E01007676","Sheffield City Region",2011,"Rotherham 025A","Total",1629,772,857,1629,0,12,334.19,4.9
"E01007677","Sheffield City Region",2011,"Rotherham 017A","Total",1467,708,759,1343,124,9,54.26,27
"E01007678","Sheffield City Region",2011,"Rotherham 023B","Total",1597,789,808,1576,21,39,161.54,9.9
"E01007679","Sheffield City Region",2011,"Rotherham 023C","Total",1854,920,934,1854,0,30,35.86,51.7
"E01007680","Sheffield City Region",2011,"Rotherham 023D","Total",1882,945,937,1880,2,16,46.9,40.1
"E01007681","Sheffield City Region",2011,"Rotherham 012A","Total",1331,647,684,1331,0,8,100.62,13.2
"E01007682","Sheffield City Region",2011,"Rotherham 019A","Total",1440,717,723,1440,0,11,23.22,62
"E01007683","Sheffield City Region",2011,"Rotherham 019B","Total",1433,714,719,1401,32,17,26.67,53.7
"E01007684","Sheffield City Region",2011,"Rotherham 022A","Total",1627,803,824,1617,10,15,45.56,35.7
"E01007685","Sheffield City Region",2011,"Rotherham 018A","Total",1437,715,722,1437,0,14,276.82,5.2
"E01007686","Sheffield City Region",2011,"Rotherham 019C","Total",1417,668,749,1417,0,19,39.85,35.6
"E01007687","Sheffield City Region",2011,"Rotherham 022B","Total",1452,701,751,1452,0,30,103.39,14
"E01007688","Sheffield City Region",2011,"Rotherham 019D","Total",1429,653,776,1429,0,22,33.96,42.1
"E01007689","Sheffield City Region",2011,"Rotherham 022C","Total",1537,735,802,1537,0,13,31.51,48.8
"E01007690","Sheffield City Region",2011,"Rotherham 022D","Total",1644,791,853,1644,0,44,309.46,5.3
"E01007691","Sheffield City Region",2011,"Rotherham 012B","Total",2045,1011,1034,2045,0,18,257.06,8
"E01007692","Sheffield City Region",2011,"Rotherham 012C","Total",1519,734,785,1519,0,20,372.53,4.1
"E01007693","Sheffield City Region",2011,"Rotherham 001A","Total",2148,1075,1073,2148,0,15,126.03,17
"E01007694","Sheffield City Region",2011,"Rotherham 001B","Total",1758,884,874,1753,5,11,59.38,29.6
"E01007695","Sheffield City Region",2011,"Rotherham 001C","Total",2461,1204,1257,2461,0,11,131.22,18.8
"E01007696","Sheffield City Region",2011,"Rotherham 007A","Total",1478,693,785,1453,25,22,2206.06,0.7
"E01007697","Sheffield City Region",2011,"Rotherham 001D","Total",1577,760,817,1522,55,10,32.16,49
"E01007698","Sheffield City Region",2011,"Rotherham 001E","Total",1517,761,756,1482,35,19,96.3,15.8
"E01007699","Sheffield City Region",2011,"Rotherham 027B","Total",1826,890,936,1826,0,12,214.98,8.5
"E01007700","Sheffield City Region",2011,"Rotherham 027C","Total",1813,863,950,1758,55,13,156.12,11.6
"E01007701","Sheffield City Region",2011,"Rotherham 027D","Total",1658,809,849,1647,11,11,334.47,5
"E01007702","Sheffield City Region",2011,"Rotherham 025B","Total",1595,780,815,1595,0,8,31.9,50
"E01007703","Sheffield City Region",2011,"Rotherham 025C","Total",1237,587,650,1237,0,15,21.24,58.2
"E01007704","Sheffield City Region",2011,"Rotherham 025D","Total",1450,712,738,1450,0,9,35.05,41.4
"E01007705","Sheffield City Region",2011,"Rotherham 025E","Total",1522,758,764,1522,0,8,42.29,36
"E01007706","Sheffield City Region",2011,"Rotherham 027E","Total",1458,742,716,1458,0,6,102.91,14.2
"E01007707","Sheffield City Region",2011,"Rotherham 025F","Total",1527,762,765,1527,0,8,47.66,32
"E01007708","Sheffield City Region",2011,"Rotherham 021A","Total",1672,773,899,1672,0,6,35.58,47
"E01007709","Sheffield City Region",2011,"Rotherham 021B","Total",1456,701,755,1456,0,18,31.5,46.2
"E01007710","Sheffield City Region",2011,"Rotherham 021C","Total",1564,762,802,1564,0,27,71.96,21.7
"E01007711","Sheffield City Region",2011,"Rotherham 021D","Total",1799,856,943,1754,45,23,39.25,45.8
"E01007712","Sheffield City Region",2011,"Rotherham 023E","Total",1965,973,992,1965,0,37,50.37,39
"E01007713","Sheffield City Region",2011,"Rotherham 023F","Total",1625,786,839,1604,21,26,43.85,37.1
"E01007714","Sheffield City Region",2011,"Rotherham 017B","Total",2022,1081,941,1992,30,10,151.69,13.3
"E01007715","Sheffield City Region",2011,"Rotherham 016A","Total",1797,923,874,1761,36,8,47.64,37.7
"E01007716","Sheffield City Region",2011,"Rotherham 016B","Total",1911,983,928,1902,9,11,108.86,17.6
"E01007717","Sheffield City Region",2011,"Rotherham 016C","Total",1898,904,994,1882,16,12,62.13,30.5
"E01007718","Sheffield City Region",2011,"Rotherham 016D","Total",1489,785,704,1489,0,6,100.18,14.9
"E01007719","Sheffield City Region",2011,"Rotherham 010A","Total",1247,618,629,1247,0,4,36.03,34.6
"E01007720","Sheffield City Region",2011,"Rotherham 010B","Total",1504,728,776,1454,50,15,905.44,1.7
"E01007721","Sheffield City Region",2011,"Rotherham 010C","Total",1575,744,831,1575,0,6,148.9,10.6
"E01007723","Sheffield City Region",2011,"Rotherham 013A","Total",1379,690,689,1379,0,7,28.78,47.9
"E01007724","Sheffield City Region",2011,"Rotherham 021E","Total",1372,665,707,1372,0,17,222.7,6.2
"E01007725","Sheffield City Region",2011,"Rotherham 019E","Total",1332,648,684,1270,62,19,20.6,64.7
"E01007726","Sheffield City Region",2011,"Rotherham 019F","Total",1600,765,835,1600,0,7,28.8,55.6
"E01007727","Sheffield City Region",2011,"Rotherham 010D","Total",1498,722,776,1498,0,2,95.26,15.7
"E01007728","Sheffield City Region",2011,"Rotherham 009A","Total",1116,561,555,1104,12,10,255.55,4.4
"E01007729","Sheffield City Region",2011,"Rotherham 009B","Total",1620,841,779,1602,18,2,28.42,57
"E01007730","Sheffield City Region",2011,"Rotherham 009C","Total",1417,711,706,1417,0,7,39.97,35.5
"E01007731","Sheffield City Region",2011,"Rotherham 009D","Total",1238,600,638,1187,51,12,151.24,8.2
"E01007732","Sheffield City Region",2011,"Rotherham 009E","Total",1415,734,681,1415,0,6,69.49,20.4
"E01007733","Sheffield City Region",2011,"Rotherham 009F","Total",1323,668,655,1323,0,4,26.5,49.9
"E01007734","Sheffield City Region",2011,"Rotherham 021F","Total",1766,795,971,1757,9,13,26.88,65.7
"E01007735","Sheffield City Region",2011,"Rotherham 013B","Total",1427,699,728,1427,0,3,54.02,26.4
"E01007736","Sheffield City Region",2011,"Rotherham 014A","Total",1618,800,818,1593,25,5,127.9,12.7
"E01007737","Sheffield City Region",2011,"Rotherham 013C","Total",1583,782,801,1583,0,5,143.77,11
"E01007738","Sheffield City Region",2011,"Rotherham 013D","Total",1516,737,779,1497,19,6,26.71,56.8
"E01007739","Sheffield City Region",2011,"Rotherham 013E","Total",1587,780,807,1587,0,7,27.05,58.7
"E01007740","Sheffield City Region",2011,"Rotherham 011A","Total",1533,726,807,1471,62,6,38.54,39.8
"E01007741","Sheffield City Region",2011,"Rotherham 015A","Total",1527,750,777,1527,0,8,31.89,47.9
"E01007742","Sheffield City Region",2011,"Rotherham 015B","Total",1421,676,745,1421,0,15,30.46,46.7
"E01007743","Sheffield City Region",2011,"Rotherham 015C","Total",1302,656,646,1302,0,17,224.64,5.8
"E01007744","Sheffield City Region",2011,"Rotherham 015D","Total",1556,794,762,1534,22,12,49.05,31.7
"E01007745","Sheffield City Region",2011,"Rotherham 015E","Total",1551,735,816,1537,14,6,95.12,16.3
"E01007746","Sheffield City Region",2011,"Rotherham 015F","Total",1542,756,786,1542,0,12,79.66,19.4
"E01007747","Sheffield City Region",2011,"Rotherham 031C","Total",1295,636,659,1295,0,5,79.44,16.3
"E01007748","Sheffield City Region",2011,"Rotherham 033A","Total",1444,688,756,1443,1,18,763.81,1.9
"E01007749","Sheffield City Region",2011,"Rotherham 033B","Total",1804,885,919,1804,0,22,88.8,20.3
"E01007750","Sheffield City Region",2011,"Rotherham 031D","Total",1521,746,775,1521,0,14,659.17,2.3
"E01007751","Sheffield City Region",2011,"Rotherham 033C","Total",1962,964,998,1962,0,17,492.58,4
"E01007752","Sheffield City Region",2011,"Rotherham 033D","Total",1487,714,773,1487,0,28,273.56,5.4
"E01007753","Sheffield City Region",2011,"Rotherham 033E","Total",1545,739,806,1527,18,17,1495.79,1
"E01007754","Sheffield City Region",2011,"Rotherham 018B","Total",1409,704,705,1387,22,20,74.59,18.9
"E01007755","Sheffield City Region",2011,"Rotherham 018C","Total",1386,691,695,1386,0,10,22.91,60.5
"E01007756","Sheffield City Region",2011,"Rotherham 018D","Total",1446,710,736,1446,0,19,32.04,45.1
"E01007757","Sheffield City Region",2011,"Rotherham 020A","Total",1669,806,863,1667,2,14,166.29,10
"E01007758","Sheffield City Region",2011,"Rotherham 020B","Total",1336,645,691,1336,0,9,34.98,38.2
"E01007759","Sheffield City Region",2011,"Rotherham 020C","Total",1473,716,757,1473,0,8,32.26,45.7
"E01007760","Sheffield City Region",2011,"Rotherham 020D","Total",1784,907,877,1784,0,6,35.21,50.7
"E01007761","Sheffield City Region",2011,"Rotherham 018E","Total",1616,782,834,1616,0,10,70.5,22.9
"E01007762","Sheffield City Region",2011,"Rotherham 018F","Total",1471,700,771,1386,85,11,61.62,23.9
"E01007763","Sheffield City Region",2011,"Rotherham 020E","Total",1561,761,800,1517,44,12,46.28,33.7
"E01007764","Sheffield City Region",2011,"Rotherham 020F","Total",1705,850,855,1704,1,8,1449.97,1.2
"E01007765","Sheffield City Region",2011,"Rotherham 014B","Total",1518,753,765,1513,5,3,19.37,78.4
"E01007766","Sheffield City Region",2011,"Rotherham 014C","Total",1468,729,739,1468,0,5,22.76,64.5
"E01007767","Sheffield City Region",2011,"Rotherham 017C","Total",1663,836,827,1501,162,21,89.59,18.6
"E01007768","Sheffield City Region",2011,"Rotherham 014D","Total",1936,1003,933,1901,35,5,36.73,52.7
"E01007769","Sheffield City Region",2011,"Rotherham 017D","Total",1728,899,829,1728,0,17,16.26,106.3
"E01007770","Sheffield City Region",2011,"Rotherham 014E","Total",1759,864,895,1744,15,10,26.96,65.2
"E01007771","Sheffield City Region",2011,"Rotherham 006A","Total",1421,701,720,1421,0,17,73.24,19.4
"E01007772","Sheffield City Region",2011,"Rotherham 006B","Total",1329,651,678,1325,4,11,186.85,7.1
"E01007773","Sheffield City Region",2011,"Rotherham 006C","Total",1412,653,759,1412,0,4,22.19,63.6
"E01007774","Sheffield City Region",2011,"Rotherham 006D","Total",1503,737,766,1503,0,7,80.84,18.6
"E01007775","Sheffield City Region",2011,"Rotherham 008A","Total",1341,637,704,1341,0,5,22.24,60.3
"E01007776","Sheffield City Region",2011,"Rotherham 008B","Total",1487,733,754,1487,0,6,109.84,13.5
"E01007777","Sheffield City Region",2011,"Rotherham 004A","Total",1616,789,827,1576,40,7,74.32,21.7
"E01007778","Sheffield City Region",2011,"Rotherham 005A","Total",1526,763,763,1526,0,12,125.57,12.2
"E01007779","Sheffield City Region",2011,"Rotherham 005B","Total",1257,638,619,1215,42,9,99.53,12.6
"E01007780","Sheffield City Region",2011,"Rotherham 005C","Total",1414,698,716,1414,0,7,74.91,18.9
"E01007781","Sheffield City Region",2011,"Rotherham 005D","Total",1524,743,781,1524,0,9,35.43,43
"E01007782","Sheffield City Region",2011,"Rotherham 005E","Total",1495,705,790,1495,0,11,60.64,24.7
"E01007783","Sheffield City Region",2011,"Rotherham 008C","Total",1674,802,872,1658,16,8,80.62,20.8
"E01007784","Sheffield City Region",2011,"Rotherham 008D","Total",1761,872,889,1645,116,8,138.63,12.7
"E01007785","Sheffield City Region",2011,"Rotherham 029C","Total",1351,650,701,1351,0,20,358.3,3.8
"E01007786","Sheffield City Region",2011,"Rotherham 029D","Total",1208,559,649,1112,96,17,29.48,41
"E01007787","Sheffield City Region",2011,"Rotherham 028A","Total",2769,1389,1380,2751,18,28,1418.43,2
"E01007788","Sheffield City Region",2011,"Rotherham 028B","Total",1501,764,737,1501,0,11,1639.58,0.9
"E01007789","Sheffield City Region",2011,"Rotherham 028C","Total",1617,787,830,1617,0,6,264.78,6.1
"E01007790","Sheffield City Region",2011,"Rotherham 029E","Total",1485,734,751,1467,18,4,48.07,30.9
"E01007791","Sheffield City Region",2011,"Rotherham 029F","Total",1371,681,690,1371,0,6,28.87,47.5
"E01007792","Sheffield City Region",2011,"Rotherham 028D","Total",1347,688,659,1347,0,36,46.2,29.2
"E01007793","Sheffield City Region",2011,"Rotherham 004B","Total",1366,688,678,1366,0,10,90.89,15
"E01007794","Sheffield City Region",2011,"Rotherham 004C","Total",1433,685,748,1433,0,6,23.83,60.1
"E01007795","Sheffield City Region",2011,"Rotherham 004D","Total",1439,722,717,1439,0,10,32.34,44.5
"E01007796","Sheffield City Region",2011,"Rotherham 003A","Total",1156,523,633,1156,0,7,20.09,57.5
"E01007797","Sheffield City Region",2011,"Rotherham 003B","Total",1362,688,674,1362,0,3,39.24,34.7
"E01007798","Sheffield City Region",2011,"Rotherham 003C","Total",1261,630,631,1261,0,15,39.9,31.6
"E01007799","Sheffield City Region",2011,"Rotherham 003D","Total",1414,685,729,1414,0,20,45.16,31.3
"E01007800","Sheffield City Region",2011,"Rotherham 003E","Total",1474,729,745,1428,46,10,102.01,14.4
"E01007801","Sheffield City Region",2011,"Rotherham 007B","Total",1491,718,773,1491,0,18,363.54,4.1
"E01007802","Sheffield City Region",2011,"Rotherham 007C","Total",1330,651,679,1330,0,17,55.56,23.9
"E01007803","Sheffield City Region",2011,"Rotherham 007D","Total",1337,664,673,1337,0,7,82,16.3
"E01007804","Sheffield City Region",2011,"Rotherham 011B","Total",1436,693,743,1430,6,10,39.63,36.2
"E01007805","Sheffield City Region",2011,"Rotherham 011C","Total",1430,683,747,1425,5,1,29.37,48.7
"E01007806","Sheffield City Region",2011,"Rotherham 011D","Total",1304,637,667,1304,0,7,20.35,64.1
"E01007807","Sheffield City Region",2011,"Rotherham 011E","Total",1448,720,728,1448,0,6,34.18,42.4
"E01007808","Sheffield City Region",2011,"Rotherham 007E","Total",1469,746,723,1469,0,31,62.91,23.4
"E01007809","Sheffield City Region",2011,"Rotherham 026B","Total",1553,781,772,1550,3,4,49.04,31.7
"E01007810","Sheffield City Region",2011,"Rotherham 026C","Total",1958,984,974,1955,3,14,378.23,5.2
"E01007811","Sheffield City Region",2011,"Rotherham 024A","Total",1358,666,692,1358,0,12,120.22,11.3
"E01007812","Sheffield City Region",2011,"Rotherham 024B","Total",1241,616,625,1241,0,12,21.91,56.6
"E01007813","Sheffield City Region",2011,"Rotherham 024C","Total",1331,676,655,1331,0,9,57.62,23.1
"E01007814","Sheffield City Region",2011,"Rotherham 024D","Total",1112,542,570,1097,15,19,827.1,1.3
"E01007815","Sheffield City Region",2011,"Rotherham 026D","Total",1715,816,899,1700,15,13,364.02,4.7
"E01007816","Sheffield City Region",2011,"Rotherham 002A","Total",1672,828,844,1655,17,26,213.32,7.8
"E01007817","Sheffield City Region",2011,"Rotherham 002B","Total",1421,676,745,1421,0,10,43.64,32.6
"E01007818","Sheffield City Region",2011,"Rotherham 003F","Total",1594,776,818,1591,3,20,131.33,12.1
"E01007819","Sheffield City Region",2011,"Rotherham 002C","Total",1481,758,723,1445,36,12,205.76,7.2
"E01007820","Sheffield City Region",2011,"Rotherham 002D","Total",1483,734,749,1483,0,15,311.03,4.8
"E01007821","Sheffield City Region",2011,"Rotherham 002E","Total",1608,746,862,1535,73,11,51.43,31.3
"E01007822","Sheffield City Region",2011,"Rotherham 002F","Total",1540,696,844,1540,0,14,72.18,21.3
"E01007823","Sheffield City Region",2011,"Sheffield 069A","Total",1658,791,867,1658,0,20,41.99,39.5
"E01007824","Sheffield City Region",2011,"Sheffield 066A","Total",1393,684,709,1393,0,21,34.55,40.3
"E01007825","Sheffield City Region",2011,"Sheffield 066B","Total",1457,682,775,1404,53,34,126.26,11.5
"E01007826","Sheffield City Region",2011,"Sheffield 066C","Total",1526,749,777,1526,0,24,104.9,14.5
"E01007827","Sheffield City Region",2011,"Sheffield 064A","Total",1504,754,750,1504,0,18,154.68,9.7
"E01007828","Sheffield City Region",2011,"Sheffield 059A","Total",1710,780,930,1699,11,11,28.17,60.7
"E01007829","Sheffield City Region",2011,"Sheffield 059B","Total",1562,784,778,1562,0,12,44.05,35.5
"E01007830","Sheffield City Region",2011,"Sheffield 064B","Total",1547,739,808,1455,92,15,28.68,53.9
"E01007831","Sheffield City Region",2011,"Sheffield 059C","Total",1523,716,807,1469,54,16,30.62,49.7
"E01007832","Sheffield City Region",2011,"Sheffield 059D","Total",1543,744,799,1543,0,19,20.37,75.7
"E01007833","Sheffield City Region",2011,"Sheffield 064C","Total",1648,789,859,1648,0,19,116.87,14.1
"E01007834","Sheffield City Region",2011,"Sheffield 066D","Total",1654,771,883,1654,0,17,65.06,25.4
"E01007835","Sheffield City Region",2011,"Sheffield 062A","Total",1442,691,751,1381,61,9,60.29,23.9
"E01007836","Sheffield City Region",2011,"Sheffield 062B","Total",1631,797,834,1605,26,8,56.03,29.1
"E01007838","Sheffield City Region",2011,"Sheffield 076A","Total",1507,731,776,1507,0,7,35.06,43
"E01007839","Sheffield City Region",2011,"Sheffield 076B","Total",1635,803,832,1635,0,11,35.76,45.7
"E01007841","Sheffield City Region",2011,"Sheffield 076C","Total",1665,793,872,1604,61,7,45.17,36.9
"E01007842","Sheffield City Region",2011,"Sheffield 076D","Total",1575,741,834,1575,0,14,64.49,24.4
"E01007843","Sheffield City Region",2011,"Sheffield 062C","Total",1600,780,820,1600,0,6,37.1,43.1
"E01007846","Sheffield City Region",2011,"Sheffield 062D","Total",1494,712,782,1494,0,6,24.25,61.6
"E01007847","Sheffield City Region",2011,"Sheffield 014A","Total",1297,650,647,1297,0,7,15.81,82
"E01007848","Sheffield City Region",2011,"Sheffield 013A","Total",1717,811,906,1616,101,7,33.86,50.7
"E01007849","Sheffield City Region",2011,"Sheffield 010A","Total",2113,1024,1089,2113,0,10,55.64,38
"E01007850","Sheffield City Region",2011,"Sheffield 014B","Total",1562,743,819,1562,0,7,98.46,15.9
"E01007851","Sheffield City Region",2011,"Sheffield 013B","Total",1483,710,773,1483,0,5,43.97,33.7
"E01007852","Sheffield City Region",2011,"Sheffield 014C","Total",1482,763,719,1482,0,8,104.87,14.1
"E01007853","Sheffield City Region",2011,"Sheffield 014D","Total",1568,775,793,1568,0,13,39.45,39.7
"E01007854","Sheffield City Region",2011,"Sheffield 014E","Total",1735,785,950,1735,0,3,54.08,32.1
"E01007855","Sheffield City Region",2011,"Sheffield 014F","Total",2035,1023,1012,1976,59,6,45.73,44.5
"E01007856","Sheffield City Region",2011,"Sheffield 007A","Total",1317,650,667,1317,0,6,72.15,18.3
"E01007857","Sheffield City Region",2011,"Sheffield 010B","Total",1557,737,820,1552,5,9,32.52,47.9
"E01007858","Sheffield City Region",2011,"Sheffield 038A","Total",1443,713,730,1358,85,29,39.11,36.9
"E01007859","Sheffield City Region",2011,"Sheffield 036A","Total",1638,870,768,1420,218,21,27.8,58.9
"E01007860","Sheffield City Region",2011,"Sheffield 036B","Total",1553,783,770,1528,25,19,27.61,56.2
"E01007861","Sheffield City Region",2011,"Sheffield 038B","Total",1525,738,787,1525,0,58,58.88,25.9
"E01007862","Sheffield City Region",2011,"Sheffield 038C","Total",4183,1985,2198,2286,1897,54,69.11,60.5
"E01007863","Sheffield City Region",2011,"Sheffield 036C","Total",1865,889,976,1702,163,31,27.91,66.8
"E01007864","Sheffield City Region",2011,"Sheffield 036D","Total",1882,932,950,1882,0,7,11.75,160.2
"E01007865","Sheffield City Region",2011,"Sheffield 038D","Total",1682,832,850,1682,0,45,44.9,37.5
"E01007866","Sheffield City Region",2011,"Sheffield 030A","Total",1727,886,841,1714,13,24,42.78,40.4
"E01007867","Sheffield City Region",2011,"Sheffield 030B","Total",2010,955,1055,2006,4,14,18.38,109.4
"E01007868","Sheffield City Region",2011,"Sheffield 030C","Total",1179,548,631,1110,69,22,28.16,41.9
"E01007869","Sheffield City Region",2011,"Sheffield 020A","Total",1714,839,875,1693,21,10,34.34,49.9
"E01007870","Sheffield City Region",2011,"Sheffield 019A","Total",1843,983,860,1756,87,19,54.69,33.7
"E01007871","Sheffield City Region",2011,"Sheffield 019B","Total",1783,926,857,1783,0,14,46.66,38.2
"E01007872","Sheffield City Region",2011,"Sheffield 020B","Total",1753,866,887,1713,40,13,46.11,38
"E01007873","Sheffield City Region",2011,"Sheffield 020C","Total",1760,914,846,1752,8,10,54.59,32.2
"E01007874","Sheffield City Region",2011,"Sheffield 022A","Total",1862,880,982,1848,14,11,23.41,79.5
"E01007875","Sheffield City Region",2011,"Sheffield 022B","Total",1838,994,844,1838,0,9,28.08,65.5
"E01007877","Sheffield City Region",2011,"Sheffield 022D","Total",1446,695,751,1372,74,5,77.26,18.7
"E01007878","Sheffield City Region",2011,"Sheffield 075A","Total",1716,1022,694,1716,0,4,25.23,68
"E01007879","Sheffield City Region",2011,"Sheffield 075B","Total",1646,854,792,1637,9,19,31.93,51.6
"E01007881","Sheffield City Region",2011,"Sheffield 075C","Total",1609,823,786,1609,0,8,54.2,29.7
"E01007882","Sheffield City Region",2011,"Sheffield 075D","Total",1637,936,701,1637,0,15,21.02,77.9
"E01007883","Sheffield City Region",2011,"Sheffield 027A","Total",1322,629,693,1322,0,6,117.5,11.3
"E01007885","Sheffield City Region",2011,"Sheffield 075E","Total",1557,774,783,1557,0,9,67.41,23.1
"E01007886","Sheffield City Region",2011,"Sheffield 075F","Total",1623,739,884,1623,0,10,36.96,43.9
"E01007887","Sheffield City Region",2011,"Sheffield 004A","Total",1362,661,701,1362,0,4,28.31,48.1
"E01007888","Sheffield City Region",2011,"Sheffield 003A","Total",1379,686,693,1379,0,10,38.15,36.1
"E01007889","Sheffield City Region",2011,"Sheffield 004B","Total",2677,1339,1338,2658,19,31,166.81,16
"E01007890","Sheffield City Region",2011,"Sheffield 004C","Total",1442,712,730,1422,20,7,26.3,54.8
"E01007891","Sheffield City Region",2011,"Sheffield 004D","Total",1551,775,776,1551,0,23,151.22,10.3
"E01007892","Sheffield City Region",2011,"Sheffield 003B","Total",1466,689,777,1448,18,5,26.32,55.7
"E01007893","Sheffield City Region",2011,"Sheffield 003C","Total",1491,728,763,1491,0,17,109.11,13.7
"E01007894","Sheffield City Region",2011,"Sheffield 004E","Total",1458,701,757,1410,48,11,97.93,14.9
"E01007895","Sheffield City Region",2011,"Sheffield 004F","Total",1456,695,761,1400,56,3,30.22,48.2
"E01007896","Sheffield City Region",2011,"Sheffield 004G","Total",1280,628,652,1280,0,14,31.35,40.8
"E01007897","Sheffield City Region",2011,"Sheffield 005A","Total",1386,699,687,1386,0,9,98.96,14
"E01007898","Sheffield City Region",2011,"Sheffield 003D","Total",1470,689,781,1469,1,11,123.77,11.9
"E01007899","Sheffield City Region",2011,"Sheffield 003E","Total",1463,704,759,1463,0,15,65.6,22.3
"E01007900","Sheffield City Region",2011,"Sheffield 003F","Total",1694,826,868,1694,0,9,36.05,47
"E01007901","Sheffield City Region",2011,"Sheffield 003G","Total",1481,710,771,1481,0,2,28.42,52.1
"E01007902","Sheffield City Region",2011,"Sheffield 027B","Total",1752,930,822,1752,0,3,250.84,7
"E01007903","Sheffield City Region",2011,"Sheffield 018A","Total",1588,813,775,1537,51,10,232.42,6.8
"E01007904","Sheffield City Region",2011,"Sheffield 018B","Total",1701,844,857,1700,1,7,184.84,9.2
"E01007905","Sheffield City Region",2011,"Sheffield 027C","Total",1770,851,919,1770,0,8,30.71,57.6
"E01007906","Sheffield City Region",2011,"Sheffield 027D","Total",2081,1054,1027,2081,0,12,27.78,74.9
"E01007907","Sheffield City Region",2011,"Sheffield 032A","Total",1656,854,802,1656,0,5,41.92,39.5
"E01007908","Sheffield City Region",2011,"Sheffield 032B","Total",1492,747,745,1492,0,7,24.84,60.1
"E01007909","Sheffield City Region",2011,"Sheffield 032C","Total",2047,1019,1028,2047,0,13,99.45,20.6
"E01007910","Sheffield City Region",2011,"Sheffield 037A","Total",1638,767,871,1579,59,11,93.85,17.5
"E01007911","Sheffield City Region",2011,"Sheffield 032D","Total",1397,683,714,1397,0,4,87.94,15.9
"E01007912","Sheffield City Region",2011,"Sheffield 037B","Total",1516,739,777,1516,0,3,26.57,57.1
"E01007913","Sheffield City Region",2011,"Sheffield 018C","Total",1481,755,726,1481,0,4,272.24,5.4
"E01007914","Sheffield City Region",2011,"Sheffield 018D","Total",1559,785,774,1559,0,13,26.71,58.4
"E01007915","Sheffield City Region",2011,"Sheffield 071A","Total",1415,663,752,1415,0,25,56.53,25
"E01007916","Sheffield City Region",2011,"Sheffield 069B","Total",1529,733,796,1529,0,7,30.62,49.9
"E01007917","Sheffield City Region",2011,"Sheffield 071B","Total",1460,699,761,1460,0,22,82.47,17.7
"E01007918","Sheffield City Region",2011,"Sheffield 071C","Total",1635,778,857,1635,0,31,51.04,32
"E01007919","Sheffield City Region",2011,"Sheffield 069C","Total",1603,757,846,1603,0,7,22.49,71.3
"E01007920","Sheffield City Region",2011,"Sheffield 068A","Total",1638,784,854,1622,16,37,84.2,19.5
"E01007921","Sheffield City Region",2011,"Sheffield 068B","Total",1571,726,845,1562,9,33,75.2,20.9
"E01007922","Sheffield City Region",2011,"Sheffield 071D","Total",1406,690,716,1406,0,35,39.4,35.7
"E01007923","Sheffield City Region",2011,"Sheffield 068C","Total",1802,859,943,1802,0,30,61.69,29.2
"E01007924","Sheffield City Region",2011,"Sheffield 071E","Total",1543,768,775,1484,59,22,48,32.1
"E01007925","Sheffield City Region",2011,"Sheffield 068D","Total",1630,789,841,1630,0,28,129.89,12.5
"E01007926","Sheffield City Region",2011,"Sheffield 068E","Total",1714,819,895,1686,28,39,889.55,1.9
"E01007927","Sheffield City Region",2011,"Sheffield 055A","Total",1672,817,855,1608,64,43,63.43,26.4
"E01007928","Sheffield City Region",2011,"Sheffield 055B","Total",1751,850,901,1751,0,83,52.76,33.2
"E01007929","Sheffield City Region",2011,"Sheffield 055C","Total",1628,816,812,1628,0,42,68.81,23.7
"E01007930","Sheffield City Region",2011,"Sheffield 055D","Total",1476,697,779,1470,6,57,61.6,24
"E01007931","Sheffield City Region",2011,"Sheffield 047A","Total",1604,762,842,1604,0,67,33.6,47.7
"E01007932","Sheffield City Region",2011,"Sheffield 055E","Total",1415,687,728,1415,0,47,98.95,14.3
"E01007933","Sheffield City Region",2011,"Sheffield 068F","Total",1663,809,854,1658,5,65,184.23,9
"E01007934","Sheffield City Region",2011,"Sheffield 047B","Total",1468,709,759,1468,0,30,42.51,34.5
"E01007935","Sheffield City Region",2011,"Sheffield 047C","Total",1419,683,736,1419,0,27,20.04,70.8
"E01007936","Sheffield City Region",2011,"Sheffield 047D","Total",1590,752,838,1590,0,23,15.47,102.8
"E01007937","Sheffield City Region",2011,"Sheffield 047E","Total",1395,682,713,1395,0,45,28.18,49.5
"E01007938","Sheffield City Region",2011,"Sheffield 047F","Total",1509,713,796,1509,0,37,36.03,41.9
"E01007939","Sheffield City Region",2011,"Sheffield 055F","Total",1534,733,801,1534,0,67,307.8,5
"E01007940","Sheffield City Region",2011,"Sheffield 022E","Total",1693,826,867,1690,3,7,18.06,93.7
"E01007941","Sheffield City Region",2011,"Sheffield 015A","Total",1623,798,825,1534,89,6,36.38,44.6
"E01007942","Sheffield City Region",2011,"Sheffield 020D","Total",1862,983,879,1834,28,10,41.87,44.5
"E01007943","Sheffield City Region",2011,"Sheffield 019C","Total",1748,828,920,1748,0,5,29.95,58.4
"E01007944","Sheffield City Region",2011,"Sheffield 022F","Total",2058,1113,945,2058,0,8,11.06,186.1
"E01007945","Sheffield City Region",2011,"Sheffield 015B","Total",1780,857,923,1771,9,2,28.72,62
"E01007946","Sheffield City Region",2011,"Sheffield 015C","Total",1585,763,822,1585,0,4,24.5,64.7
"E01007947","Sheffield City Region",2011,"Sheffield 013C","Total",1626,794,832,1615,11,7,30.83,52.7
"E01007948","Sheffield City Region",2011,"Sheffield 013D","Total",1757,786,971,1756,1,11,24.06,73
"E01007949","Sheffield City Region",2011,"Sheffield 020E","Total",1592,792,800,1555,37,11,20.95,76
"E01007950","Sheffield City Region",2011,"Sheffield 015D","Total",1529,720,809,1529,0,2,24.68,62
"E01007951","Sheffield City Region",2011,"Sheffield 029A","Total",1585,769,816,1567,18,16,28.55,55.5
"E01007952","Sheffield City Region",2011,"Sheffield 033A","Total",1569,758,811,1569,0,50,35.07,44.7
"E01007953","Sheffield City Region",2011,"Sheffield 033B","Total",1565,746,819,1561,4,30,114.51,13.7
"E01007954","Sheffield City Region",2011,"Sheffield 033C","Total",1650,799,851,1650,0,30,37.02,44.6
"E01007955","Sheffield City Region",2011,"Sheffield 041A","Total",1371,659,712,1371,0,40,39.73,34.5
"E01007956","Sheffield City Region",2011,"Sheffield 041B","Total",2197,1070,1127,2196,1,60,2967.36,0.7
"E01007957","Sheffield City Region",2011,"Sheffield 041C","Total",1629,804,825,1629,0,31,37.66,43.3
"E01007958","Sheffield City Region",2011,"Sheffield 041D","Total",1465,689,776,1458,7,57,64.56,22.7
"E01007959","Sheffield City Region",2011,"Sheffield 041E","Total",1491,706,785,1491,0,42,49.58,30.1
"E01007960","Sheffield City Region",2011,"Sheffield 029B","Total",1580,762,818,1580,0,9,23.01,68.7
"E01007961","Sheffield City Region",2011,"Sheffield 033D","Total",1508,749,759,1508,0,23,145.5,10.4
"E01007962","Sheffield City Region",2011,"Sheffield 029C","Total",1465,690,775,1426,39,16,11.69,125.3
"E01007963","Sheffield City Region",2011,"Sheffield 045A","Total",1443,713,730,1443,0,7,61.29,23.5
"E01007964","Sheffield City Region",2011,"Sheffield 049A","Total",1529,752,777,1517,12,5,41.58,36.8
"E01007965","Sheffield City Region",2011,"Sheffield 044A","Total",1906,865,1041,1906,0,15,28.06,67.9
"E01007966","Sheffield City Region",2011,"Sheffield 049B","Total",1551,753,798,1551,0,5,79.03,19.6
"E01007967","Sheffield City Region",2011,"Sheffield 045B","Total",1668,821,847,1665,3,4,50.38,33.1
"E01007968","Sheffield City Region",2011,"Sheffield 049C","Total",1467,703,764,1467,0,7,42.6,34.4
"E01007969","Sheffield City Region",2011,"Sheffield 044B","Total",1557,781,776,1418,139,4,68.1,22.9
"E01007970","Sheffield City Region",2011,"Sheffield 049D","Total",1577,830,747,1528,49,0,67.49,23.4
"E01007971","Sheffield City Region",2011,"Sheffield 037C","Total",1434,688,746,1434,0,14,50.4,28.5
"E01007972","Sheffield City Region",2011,"Sheffield 044C","Total",1473,707,766,1473,0,4,60.34,24.4
"E01007973","Sheffield City Region",2011,"Sheffield 037D","Total",1523,763,760,1523,0,7,36.82,41.4
"E01007974","Sheffield City Region",2011,"Sheffield 044D","Total",1468,722,746,1468,0,7,96.7,15.2
"E01007975","Sheffield City Region",2011,"Sheffield 051A","Total",1636,828,808,1636,0,5,27.19,60.2
"E01007976","Sheffield City Region",2011,"Sheffield 051B","Total",1485,708,777,1426,59,19,33.23,44.7
"E01007977","Sheffield City Region",2011,"Sheffield 051C","Total",1496,750,746,1496,0,3,31.19,48
"E01007978","Sheffield City Region",2011,"Sheffield 053A","Total",1664,844,820,1664,0,16,26.4,63
"E01007979","Sheffield City Region",2011,"Sheffield 051D","Total",1634,721,913,1614,20,3,39.64,41.2
"E01007980","Sheffield City Region",2011,"Sheffield 053B","Total",1544,738,806,1527,17,22,15.03,102.7
"E01007981","Sheffield City Region",2011,"Sheffield 053C","Total",1448,744,704,1427,21,19,48.66,29.8
"E01007982","Sheffield City Region",2011,"Sheffield 054A","Total",1821,923,898,1821,0,17,44.46,41
"E01007983","Sheffield City Region",2011,"Sheffield 053D","Total",1483,731,752,1483,0,11,23.26,63.8
"E01007984","Sheffield City Region",2011,"Sheffield 064D","Total",1435,711,724,1435,0,9,31.54,45.5
"E01007985","Sheffield City Region",2011,"Sheffield 053E","Total",1555,764,791,1515,40,9,26.4,58.9
"E01007986","Sheffield City Region",2011,"Sheffield 059E","Total",1369,685,684,1369,0,15,16.79,81.5
"E01007987","Sheffield City Region",2011,"Sheffield 016A","Total",1468,721,747,1468,0,14,17.43,84.2
"E01007988","Sheffield City Region",2011,"Sheffield 016B","Total",1520,722,798,1520,0,14,31.76,47.9
"E01007989","Sheffield City Region",2011,"Sheffield 016C","Total",1419,666,753,1419,0,13,13.01,109.1
"E01007990","Sheffield City Region",2011,"Sheffield 021A","Total",1485,722,763,1485,0,10,32.01,46.4
"E01007991","Sheffield City Region",2011,"Sheffield 016D","Total",1503,674,829,1503,0,10,28.66,52.4
"E01007992","Sheffield City Region",2011,"Sheffield 021B","Total",1624,798,826,1612,12,19,15.29,106.2
"E01007993","Sheffield City Region",2011,"Sheffield 021C","Total",1682,835,847,1682,0,6,27.13,62
"E01007994","Sheffield City Region",2011,"Sheffield 021D","Total",1435,700,735,1435,0,8,12.65,113.4
"E01007995","Sheffield City Region",2011,"Sheffield 017A","Total",1472,719,753,1470,2,12,13.66,107.8
"E01007996","Sheffield City Region",2011,"Sheffield 021E","Total",1552,756,796,1532,20,10,49.17,31.6
"E01007997","Sheffield City Region",2011,"Sheffield 025A","Total",1479,716,763,1479,0,18,38.11,38.8
"E01007998","Sheffield City Region",2011,"Sheffield 025B","Total",1592,807,785,1561,31,2,20.72,76.8
"E01007999","Sheffield City Region",2011,"Sheffield 045C","Total",1349,678,671,1349,0,12,30.76,43.9
"E01008000","Sheffield City Region",2011,"Sheffield 052A","Total",1503,729,774,1446,57,4,30.74,48.9
"E01008001","Sheffield City Region",2011,"Sheffield 052B","Total",1535,741,794,1471,64,9,39.93,38.4
"E01008002","Sheffield City Region",2011,"Sheffield 054B","Total",1565,773,792,1557,8,11,26.56,58.9
"E01008003","Sheffield City Region",2011,"Sheffield 054C","Total",1410,681,729,1410,0,7,28.06,50.2
"E01008004","Sheffield City Region",2011,"Sheffield 052C","Total",1606,752,854,1606,0,6,31.34,51.2
"E01008005","Sheffield City Region",2011,"Sheffield 052D","Total",1546,757,789,1546,0,11,35.96,43
"E01008006","Sheffield City Region",2011,"Sheffield 054D","Total",1362,658,704,1362,0,3,25.93,52.5
"E01008007","Sheffield City Region",2011,"Sheffield 060A","Total",1698,849,849,1658,40,10,60.21,28.2
"E01008008","Sheffield City Region",2011,"Sheffield 045D","Total",1648,759,889,1617,31,9,32.9,50.1
"E01008009","Sheffield City Region",2011,"Sheffield 045E","Total",1547,713,834,1547,0,4,24.7,62.6
"E01008010","Sheffield City Region",2011,"Sheffield 052E","Total",1454,688,766,1454,0,8,24.04,60.5
"E01008011","Sheffield City Region",2011,"Sheffield 039A","Total",1633,786,847,1633,0,6,34.67,47.1
"E01008012","Sheffield City Region",2011,"Sheffield 039B","Total",2144,1044,1100,2144,0,16,50.97,42.1
"E01008013","Sheffield City Region",2011,"Sheffield 039C","Total",1168,574,594,1168,0,2,38.28,30.5
"E01008014","Sheffield City Region",2011,"Sheffield 032E","Total",1579,752,827,1531,48,6,46.64,33.9
"E01008015","Sheffield City Region",2011,"Sheffield 039D","Total",1608,836,772,1608,0,5,78.87,20.4
"E01008016","Sheffield City Region",2011,"Sheffield 032F","Total",1492,764,728,1466,26,3,42.66,35
"E01008017","Sheffield City Region",2011,"Sheffield 039E","Total",1588,792,796,1588,0,5,71.22,22.3
"E01008018","Sheffield City Region",2011,"Sheffield 039F","Total",1287,599,688,1283,4,2,39.64,32.5
"E01008019","Sheffield City Region",2011,"Sheffield 065A","Total",1866,900,966,1840,26,13,105.68,17.7
"E01008020","Sheffield City Region",2011,"Sheffield 065B","Total",1434,727,707,1434,0,12,20.68,69.3
"E01008021","Sheffield City Region",2011,"Sheffield 072A","Total",1472,732,740,1472,0,19,135.5,10.9
"E01008022","Sheffield City Region",2011,"Sheffield 065C","Total",1513,770,743,1513,0,3,19.4,78
"E01008023","Sheffield City Region",2011,"Sheffield 072B","Total",2110,1087,1023,2110,0,18,63.65,33.2
"E01008024","Sheffield City Region",2011,"Sheffield 072C","Total",1786,869,917,1786,0,4,114.1,15.7
"E01008025","Sheffield City Region",2011,"Sheffield 072D","Total",2021,989,1032,2021,0,9,233.11,8.7
"E01008027","Sheffield City Region",2011,"Sheffield 065D","Total",1532,750,782,1501,31,4,31.53,48.6
"E01008028","Sheffield City Region",2011,"Sheffield 056A","Total",1547,749,798,1547,0,3,54.32,28.5
"E01008029","Sheffield City Region",2011,"Sheffield 056B","Total",1496,739,757,1496,0,11,49.63,30.1
"E01008030","Sheffield City Region",2011,"Sheffield 063A","Total",1456,714,742,1384,72,11,44.85,32.5
"E01008031","Sheffield City Region",2011,"Sheffield 061A","Total",1436,701,735,1436,0,5,27.44,52.3
"E01008032","Sheffield City Region",2011,"Sheffield 056C","Total",1407,672,735,1407,0,8,30.04,46.8
"E01008033","Sheffield City Region",2011,"Sheffield 061B","Total",1290,630,660,1290,0,10,63.75,20.2
"E01008034","Sheffield City Region",2011,"Sheffield 056D","Total",1745,837,908,1737,8,12,81.43,21.4
"E01008035","Sheffield City Region",2011,"Sheffield 063B","Total",1195,617,578,1195,0,11,49.69,24
"E01008036","Sheffield City Region",2011,"Sheffield 063C","Total",1427,723,704,1427,0,20,17.91,79.7
"E01008037","Sheffield City Region",2011,"Sheffield 065E","Total",1392,629,763,1392,0,6,58.37,23.8
"E01008038","Sheffield City Region",2011,"Sheffield 061C","Total",1535,734,801,1535,0,14,33.69,45.6
"E01008039","Sheffield City Region",2011,"Sheffield 065F","Total",1312,625,687,1312,0,8,50.29,26.1
"E01008040","Sheffield City Region",2011,"Sheffield 061D","Total",1704,845,859,1704,0,23,72.86,23.4
"E01008041","Sheffield City Region",2011,"Sheffield 063D","Total",1519,742,777,1519,0,14,116.65,13
"E01008042","Sheffield City Region",2011,"Sheffield 050A","Total",1634,852,782,1616,18,27,19.93,82
"E01008043","Sheffield City Region",2011,"Sheffield 046A","Total",1730,847,883,1730,0,30,48.02,36
"E01008044","Sheffield City Region",2011,"Sheffield 046B","Total",1615,770,845,1603,12,19,38.05,42.4
"E01008045","Sheffield City Region",2011,"Sheffield 050B","Total",1393,696,697,1377,16,27,21.65,64.3
"E01008046","Sheffield City Region",2011,"Sheffield 050C","Total",1659,832,827,1659,0,23,20.4,81.3
"E01008047","Sheffield City Region",2011,"Sheffield 046C","Total",1509,782,727,1509,0,22,11.34,133.1
"E01008048","Sheffield City Region",2011,"Sheffield 046D","Total",1534,793,741,1516,18,21,26.89,57
"E01008049","Sheffield City Region",2011,"Sheffield 050D","Total",1589,775,814,1527,62,18,42.04,37.8
"E01008050","Sheffield City Region",2011,"Sheffield 046E","Total",1411,727,684,1411,0,23,16.16,87.3
"E01008051","Sheffield City Region",2011,"Sheffield 050E","Total",1762,924,838,1741,21,24,16.78,105
"E01008052","Sheffield City Region",2011,"Sheffield 050F","Total",1794,958,836,1782,12,31,24.92,72
"E01008053","Sheffield City Region",2011,"Sheffield 006A","Total",1245,611,634,1245,0,3,26.42,47.1
"E01008054","Sheffield City Region",2011,"Sheffield 007B","Total",1324,623,701,1324,0,7,19.5,67.9
"E01008055","Sheffield City Region",2011,"Sheffield 007C","Total",1485,689,796,1485,0,6,39.55,37.5
"E01008056","Sheffield City Region",2011,"Sheffield 006B","Total",1497,732,765,1497,0,15,26.28,57
"E01008057","Sheffield City Region",2011,"Sheffield 007D","Total",1489,700,789,1489,0,7,31.89,46.7
"E01008058","Sheffield City Region",2011,"Sheffield 006C","Total",1465,715,750,1460,5,6,44.04,33.3
"E01008059","Sheffield City Region",2011,"Sheffield 010C","Total",1512,700,812,1512,0,7,23.17,65.3
"E01008060","Sheffield City Region",2011,"Sheffield 010D","Total",1386,655,731,1386,0,9,29.33,47.3
"E01008061","Sheffield City Region",2011,"Sheffield 011A","Total",1596,744,852,1596,0,5,27.6,57.8
"E01008062","Sheffield City Region",2011,"Sheffield 013E","Total",1693,796,897,1693,0,10,20.72,81.7
"E01008063","Sheffield City Region",2011,"Sheffield 011B","Total",1541,760,781,1505,36,13,48.08,32.1
"E01008064","Sheffield City Region",2011,"Sheffield 028A","Total",1687,850,837,1687,0,15,12.6,133.9
"E01008065","Sheffield City Region",2011,"Sheffield 026A","Total",1922,1056,866,1903,19,6,24.98,76.9
"E01008066","Sheffield City Region",2011,"Sheffield 028B","Total",1598,799,799,1554,44,15,9.81,162.9
"E01008067","Sheffield City Region",2011,"Sheffield 030D","Total",1684,886,798,1646,38,6,30.34,55.5
"E01008068","Sheffield City Region",2011,"Sheffield 026B","Total",2860,1458,1402,2077,783,24,22.83,125.3
"E01008069","Sheffield City Region",2011,"Sheffield 028C","Total",1617,815,802,1617,0,19,10.83,149.3
"E01008072","Sheffield City Region",2011,"Sheffield 026C","Total",1590,816,774,1552,38,6,56.23,28.3
"E01008073","Sheffield City Region",2011,"Sheffield 030E","Total",1702,922,780,1702,0,16,22.67,75.1
"E01008074","Sheffield City Region",2011,"Sheffield 028D","Total",1460,760,700,1460,0,29,12.82,113.9
"E01008075","Sheffield City Region",2011,"Sheffield 060B","Total",1441,685,756,1441,0,5,39.22,36.7
"E01008076","Sheffield City Region",2011,"Sheffield 060C","Total",1352,648,704,1352,0,4,20.26,66.7
"E01008077","Sheffield City Region",2011,"Sheffield 060D","Total",1461,684,777,1461,0,10,22.26,65.6
"E01008078","Sheffield City Region",2011,"Sheffield 064E","Total",1335,649,686,1335,0,18,86.46,15.4
"E01008079","Sheffield City Region",2011,"Sheffield 064F","Total",1235,609,626,1235,0,23,68.4,18.1
"E01008080","Sheffield City Region",2011,"Sheffield 069D","Total",1483,735,748,1483,0,15,29.68,50
"E01008081","Sheffield City Region",2011,"Sheffield 070A","Total",1481,784,697,1481,0,3,39.44,37.6
"E01008082","Sheffield City Region",2011,"Sheffield 070B","Total",1488,711,777,1488,0,6,44.4,33.5
"E01008083","Sheffield City Region",2011,"Sheffield 070C","Total",1514,699,815,1471,43,2,23.3,65
"E01008084","Sheffield City Region",2011,"Sheffield 070D","Total",1644,791,853,1644,0,5,27.29,60.2
"E01008085","Sheffield City Region",2011,"Sheffield 009A","Total",1368,660,708,1368,0,3,29.03,47.1
"E01008086","Sheffield City Region",2011,"Sheffield 009B","Total",1349,643,706,1349,0,11,34.08,39.6
"E01008087","Sheffield City Region",2011,"Sheffield 012A","Total",1555,766,789,1514,41,9,40.45,38.4
"E01008088","Sheffield City Region",2011,"Sheffield 012B","Total",1429,703,726,1429,0,4,26.66,53.6
"E01008089","Sheffield City Region",2011,"Sheffield 017B","Total",1679,807,872,1679,0,10,148.32,11.3
"E01008090","Sheffield City Region",2011,"Sheffield 012C","Total",1624,773,851,1624,0,3,29.72,54.6
"E01008091","Sheffield City Region",2011,"Sheffield 017C","Total",1464,746,718,1464,0,9,50.82,28.8
"E01008092","Sheffield City Region",2011,"Sheffield 012D","Total",1427,696,731,1389,38,3,66.39,21.5
"E01008093","Sheffield City Region",2011,"Sheffield 017D","Total",1455,720,735,1455,0,3,111.76,13
"E01008094","Sheffield City Region",2011,"Sheffield 019D","Total",1115,565,550,1115,0,1,40.78,27.3
"E01008095","Sheffield City Region",2011,"Sheffield 043A","Total",1589,857,732,1245,344,11,82.73,19.2
"E01008096","Sheffield City Region",2011,"Sheffield 043B","Total",2176,1023,1153,2176,0,3,60.66,35.9
"E01008097","Sheffield City Region",2011,"Sheffield 043C","Total",1621,784,837,1572,49,8,38.28,42.3
"E01008098","Sheffield City Region",2011,"Sheffield 048A","Total",1590,740,850,1590,0,6,24.56,64.7
"E01008099","Sheffield City Region",2011,"Sheffield 051E","Total",1598,823,775,1545,53,14,23.6,67.7
"E01008100","Sheffield City Region",2011,"Sheffield 048B","Total",1265,587,678,1265,0,3,24.74,51.1
"E01008101","Sheffield City Region",2011,"Sheffield 043D","Total",1763,859,904,1763,0,5,20.8,84.8
"E01008102","Sheffield City Region",2011,"Sheffield 048C","Total",1115,517,598,1115,0,2,26.51,42.1
"E01008103","Sheffield City Region",2011,"Sheffield 048D","Total",1410,676,734,1390,20,5,25.91,54.4
"E01008104","Sheffield City Region",2011,"Sheffield 036E","Total",1587,827,760,1406,181,23,36.41,43.6
"E01008105","Sheffield City Region",2011,"Sheffield 040A","Total",3329,1689,1640,2046,1283,24,18.02,184.7
"E01008107","Sheffield City Region",2011,"Sheffield 040C","Total",1527,805,722,1492,35,14,10.89,140.2
"E01008108","Sheffield City Region",2011,"Sheffield 042A","Total",1981,1077,904,1972,9,18,31.92,62.1
"E01008109","Sheffield City Region",2011,"Sheffield 042B","Total",2035,1064,971,1993,42,21,23.49,86.6
"E01008111","Sheffield City Region",2011,"Sheffield 040D","Total",1688,826,862,1592,96,20,27.11,62.3
"E01008112","Sheffield City Region",2011,"Sheffield 042D","Total",1750,953,797,1750,0,13,21.89,79.9
"E01008113","Sheffield City Region",2011,"Sheffield 042E","Total",1732,922,810,1732,0,23,13.7,126.4
"E01008114","Sheffield City Region",2011,"Sheffield 074A","Total",2615,1295,1320,2309,306,25,30.95,84.5
"E01008115","Sheffield City Region",2011,"Sheffield 074B","Total",1817,1029,788,1775,42,9,14.95,121.5
"E01008116","Sheffield City Region",2011,"Sheffield 009C","Total",1327,652,675,1327,0,4,36.01,36.9
"E01008117","Sheffield City Region",2011,"Sheffield 009D","Total",1221,633,588,1221,0,5,32.08,38.1
"E01008118","Sheffield City Region",2011,"Sheffield 009E","Total",1397,687,710,1397,0,15,36.02,38.8
"E01008119","Sheffield City Region",2011,"Sheffield 009F","Total",1279,606,673,1248,31,5,35.56,36
"E01008122","Sheffield City Region",2011,"Sheffield 012E","Total",1350,648,702,1350,0,4,22.53,59.9
"E01008123","Sheffield City Region",2011,"Sheffield 015E","Total",1313,635,678,1293,20,7,36.08,36.4
"E01008124","Sheffield City Region",2011,"Sheffield 012F","Total",1499,709,790,1499,0,3,25.7,58.3
"E01008125","Sheffield City Region",2011,"Sheffield 009G","Total",1481,707,774,1481,0,6,29.13,50.8
"E01008126","Sheffield City Region",2011,"Sheffield 008A","Total",1552,758,794,1552,0,22,88.61,17.5
"E01008128","Sheffield City Region",2011,"Sheffield 008C","Total",1714,846,868,1702,12,15,11869.77,0.1
"E01008129","Sheffield City Region",2011,"Sheffield 023A","Total",1409,694,715,1377,32,22,1511.68,0.9
"E01008130","Sheffield City Region",2011,"Sheffield 023B","Total",1494,716,778,1494,0,18,160.23,9.3
"E01008131","Sheffield City Region",2011,"Sheffield 023C","Total",1576,757,819,1576,0,15,37.65,41.9
"E01008132","Sheffield City Region",2011,"Sheffield 023D","Total",1416,691,725,1416,0,22,45.42,31.2
"E01008133","Sheffield City Region",2011,"Sheffield 023E","Total",1530,724,806,1530,0,17,66.53,23
"E01008134","Sheffield City Region",2011,"Sheffield 005B","Total",1331,641,690,1331,0,21,126.17,10.5
"E01008135","Sheffield City Region",2011,"Sheffield 005C","Total",1770,864,906,1710,60,10,557.57,3.2
"E01008136","Sheffield City Region",2011,"Sheffield 008D","Total",1355,682,673,1355,0,19,129.6,10.5
"E01008137","Sheffield City Region",2011,"Sheffield 005D","Total",1441,676,765,1441,0,22,119.97,12
"E01008138","Sheffield City Region",2011,"Sheffield 006D","Total",1302,618,684,1302,0,7,29.64,43.9
"E01008139","Sheffield City Region",2011,"Sheffield 006E","Total",1582,782,800,1582,0,6,38.17,41.4
"E01008140","Sheffield City Region",2011,"Sheffield 008E","Total",1806,877,929,1786,20,18,56.03,32.2
"E01008141","Sheffield City Region",2011,"Sheffield 005E","Total",1591,758,833,1589,2,15,206.43,7.7
"E01008142","Sheffield City Region",2011,"Sheffield 002A","Total",1478,738,740,1464,14,9,42.01,35.2
"E01008143","Sheffield City Region",2011,"Sheffield 002B","Total",1620,794,826,1620,0,20,99.28,16.3
"E01008144","Sheffield City Region",2011,"Sheffield 001A","Total",1666,825,841,1614,52,10,256.04,6.5
"E01008145","Sheffield City Region",2011,"Sheffield 001B","Total",1472,735,737,1472,0,22,57.09,25.8
"E01008146","Sheffield City Region",2011,"Sheffield 002C","Total",1334,656,678,1334,0,20,24.02,55.5
"E01008147","Sheffield City Region",2011,"Sheffield 002D","Total",1426,688,738,1426,0,11,1166.08,1.2
"E01008148","Sheffield City Region",2011,"Sheffield 001C","Total",1509,739,770,1509,0,10,77.21,19.5
"E01008149","Sheffield City Region",2011,"Sheffield 001D","Total",1496,733,763,1496,0,11,148.08,10.1
"E01008150","Sheffield City Region",2011,"Sheffield 001E","Total",1454,686,768,1372,82,5,33.48,43.4
"E01008151","Sheffield City Region",2011,"Sheffield 024A","Total",1539,818,721,1539,0,21,17.6,87.4
"E01008152","Sheffield City Region",2011,"Sheffield 025C","Total",1426,722,704,1426,0,15,49.86,28.6
"E01008153","Sheffield City Region",2011,"Sheffield 024B","Total",1653,837,816,1653,0,10,19.18,86.2
"E01008154","Sheffield City Region",2011,"Sheffield 024C","Total",1628,778,850,1628,0,14,29.41,55.4
"E01008155","Sheffield City Region",2011,"Sheffield 024D","Total",1546,792,754,1546,0,9,16.88,91.6
"E01008156","Sheffield City Region",2011,"Sheffield 024E","Total",1449,720,729,1449,0,10,24.62,58.9
"E01008157","Sheffield City Region",2011,"Sheffield 026D","Total",1557,742,815,1557,0,3,34.13,45.6
"E01008158","Sheffield City Region",2011,"Sheffield 025D","Total",1535,730,805,1535,0,20,231.28,6.6
"E01008159","Sheffield City Region",2011,"Sheffield 029D","Total",1527,735,792,1527,0,7,18.24,83.7
"E01008160","Sheffield City Region",2011,"Sheffield 024F","Total",1399,660,739,1399,0,8,34.76,40.2
"E01008161","Sheffield City Region",2011,"Sheffield 026E","Total",1668,833,835,1668,0,4,38.06,43.8
"E01032550","Sheffield City Region",2011,"Barnsley 010G","Total",2841,1408,1433,2841,0,19,158.31,17.9
"E01032551","Sheffield City Region",2011,"Barnsley 010H","Total",2567,1285,1282,2567,0,15,119.47,21.5
"E01032585","Sheffield City Region",2011,"Sheffield 072E","Total",1409,691,718,1409,0,12,35.89,39.3
"E01032924","Sheffield City Region",2011,"Barnsley 026F","Total",1562,761,801,1535,27,9,313.76,5
"E01032925","Sheffield City Region",2011,"Barnsley 026G","Total",1390,656,734,1327,63,6,50.4,27.6
"E01032926","Sheffield City Region",2011,"Rotherham 012E","Total",1773,886,887,1762,11,14,59.18,30
"E01032927","Sheffield City Region",2011,"Rotherham 012F","Total",1505,741,764,1505,0,6,90.78,16.6
"E01033259","Sheffield City Region",2011,"Doncaster 014E","Total",1599,784,815,1567,32,8,47.58,33.6
"E01033260","Sheffield City Region",2011,"Doncaster 014F","Total",1611,807,804,1611,0,12,44.53,36.2
"E01033261","Sheffield City Region",2011,"Sheffield 073A","Total",1767,901,866,1701,66,17,12.94,136.6
"E01033262","Sheffield City Region",2011,"Sheffield 073B","Total",1749,1064,685,1139,610,10,23.42,74.7
"E01033263","Sheffield City Region",2011,"Sheffield 073C","Total",1330,692,638,1330,0,8,27.5,48.4
"E01033264","Sheffield City Region",2011,"Sheffield 073D","Total",1487,698,789,1299,188,15,38.88,38.2
"E01033265","Sheffield City Region",2011,"Sheffield 074C","Total",1304,756,548,966,338,13,17.41,74.9
"E01033266","Sheffield City Region",2011,"Sheffield 074D","Total",1611,879,732,1424,187,13,15.88,101.4
"E01033267","Sheffield City Region",2011,"Sheffield 074E","Total",1387,656,731,1386,1,20,4.92,281.9
"E01033268","Sheffield City Region",2011,"Sheffield 075G","Total",2373,1333,1040,2359,14,16,91.14,26
"E01033269","Sheffield City Region",2011,"Sheffield 022G","Total",1919,988,931,1919,0,8,287.12,6.7
"E01033270","Sheffield City Region",2011,"Sheffield 022H","Total",1484,862,622,1463,21,1,108.96,13.6
"E01033271","Sheffield City Region",2011,"Sheffield 040E","Total",1403,817,586,1403,0,5,17.37,80.8
"E01033272","Sheffield City Region",2011,"Sheffield 040F","Total",1159,639,520,1154,5,3,10.61,109.2
"E01033273","Sheffield City Region",2011,"Sheffield 042F","Total",2422,1246,1176,1576,846,33,27.55,87.9
"E01033274","Sheffield City Region",2011,"Sheffield 042G","Total",2410,1130,1280,1287,1123,29,35.55,67.8
"E01033275","Sheffield City Region",2011,"Sheffield 008F","Total",1611,804,807,1611,0,10,45.2,35.6
"E01033276","Sheffield City Region",2011,"Sheffield 073E","Total",2923,1570,1353,1641,1282,31,11.9,245.6
"E01033277","Sheffield City Region",2011,"Sheffield 011E","Total",2334,1163,1171,2334,0,9,72.9,32
"E01033278","Sheffield City Region",2011,"Sheffield 076E","Total",2431,1145,1286,2431,0,9,80.66,30.1
"E01033279","Sheffield City Region",2011,"Sheffield 076F","Total",2378,1179,1199,2313,65,6,102.32,23.2
"E01033280","Sheffield City Region",2011,"Sheffield 008G","Total",1637,843,794,1575,62,31,281.15,5.8
